Date,Description,Details,Reference Number,Check Number,Withdrawals,Debits,Payments,Deposits,Credits,Amount,Balance,Running Balance,Transaction Type,Currency
2025-01-03,Settlement from Amex,Processor Payout Batch,SET-20250101-Amex-Amex-AUD,,0,0,0,15222.22,15222.22,15222.22,1015222.22,1015222.22,ACH,AUD
2025-01-03,Settlement from PayPal,Processor Payout Batch,SET-20250101-PayPal-N/A-USD,,0,0,0,678343.79,678343.79,678343.79,1693566.01,1693566.01,ACH,USD
2025-01-03,Settlement from PayPal,Processor Payout Batch,SET-20250101-PayPal-N/A-GBP,,0,0,0,102989.59,102989.59,102989.59,1796555.6,1796555.6,ACH,GBP
2025-01-03,Settlement from PayPal,Processor Payout Batch,SET-20250101-PayPal-N/A-EUR,,0,0,0,168351.52,168351.52,168351.52,1964907.12,1964907.12,ACH,EUR
2025-01-03,Settlement from PayPal,Processor Payout Batch,SET-20250101-PayPal-N/A-CAD,,0,0,0,82463.12,82463.12,82463.12,2047370.2400000002,2047370.2400000002,ACH,CAD
2025-01-03,Settlement from PayPal,Processor Payout Batch,SET-20250101-PayPal-N/A-AUD,,0,0,0,96608.97,96608.97,96608.97,2143979.2100000004,2143979.2100000004,ACH,AUD
2025-01-03,Settlement from GoCardless,Processor Payout Batch,SET-20250101-GoCardless-N/A-USD,,0,0,0,586609.63,586609.63,586609.63,2730588.8400000003,2730588.8400000003,ACH,USD
2025-01-03,Settlement from GoCardless,Processor Payout Batch,SET-20250101-GoCardless-N/A-EUR,,0,0,0,126643.02,126643.02,126643.02,2857231.8600000003,2857231.8600000003,ACH,EUR
2025-01-03,Settlement from GoCardless,Processor Payout Batch,SET-20250101-GoCardless-N/A-CAD,,0,0,0,99735.2,99735.2,99735.2,2956967.0600000005,2956967.0600000005,ACH,CAD
2025-01-03,Settlement from GoCardless,Processor Payout Batch,SET-20250101-GoCardless-N/A-AUD,,0,0,0,60413.18,60413.18,60413.18,3017380.2400000007,3017380.2400000007,ACH,AUD
2025-01-03,Settlement from ClientLine,Processor Payout Batch,SET-20250101-ClientLine-Visa-USD,,0,0,0,213029.77,213029.77,213029.77,3230410.0100000007,3230410.0100000007,ACH,USD
2025-01-03,Settlement from ClientLine,Processor Payout Batch,SET-20250101-ClientLine-Visa-GBP,,0,0,0,34421.86,34421.86,34421.86,3264831.8700000006,3264831.8700000006,ACH,GBP
2025-01-03,Settlement from GoCardless,Processor Payout Batch,SET-20250101-GoCardless-N/A-GBP,,0,0,0,129921.22,129921.22,129921.22,3394753.090000001,3394753.090000001,ACH,GBP
2025-01-03,Settlement from ClientLine,Processor Payout Batch,SET-20250101-ClientLine-Visa-CAD,,0,0,0,31204.85,31204.85,31204.85,3425957.940000001,3425957.940000001,ACH,CAD
2025-01-03,Settlement from ClientLine,Processor Payout Batch,SET-20250101-ClientLine-Visa-EUR,,0,0,0,44337.5,44337.5,44337.5,3470295.440000001,3470295.440000001,ACH,EUR
2025-01-03,Settlement from Amex,Processor Payout Batch,SET-20250101-Amex-Amex-EUR,,0,0,0,62746.42,62746.42,62746.42,3533041.860000001,3533041.860000001,ACH,EUR
2025-01-03,Settlement from Amex,Processor Payout Batch,SET-20250101-Amex-Amex-GBP,,0,0,0,48805.28,48805.28,48805.28,3581847.1400000006,3581847.1400000006,ACH,GBP
2025-01-03,Settlement from Amex,Processor Payout Batch,SET-20250101-Amex-Amex-USD,,0,0,0,199320.15,199320.15,199320.15,3781167.2900000005,3781167.2900000005,ACH,USD
2025-01-03,Settlement from ClientLine,Processor Payout Batch,SET-20250101-ClientLine-Mastercard-AUD,,0,0,0,27893.14,27893.14,27893.14,3809060.4300000006,3809060.4300000006,ACH,AUD
2025-01-03,Settlement from Amex,Processor Payout Batch,SET-20250101-Amex-Amex-CAD,,0,0,0,14915.24,14915.24,14915.24,3823975.670000001,3823975.670000001,ACH,CAD
2025-01-03,Settlement from ClientLine,Processor Payout Batch,SET-20250101-ClientLine-Mastercard-EUR,,0,0,0,50003.01,50003.01,50003.01,3873978.6800000006,3873978.6800000006,ACH,EUR
2025-01-03,Settlement from ClientLine,Processor Payout Batch,SET-20250101-ClientLine-Mastercard-GBP,,0,0,0,24364.06,24364.06,24364.06,3898342.7400000007,3898342.7400000007,ACH,GBP
2025-01-03,Settlement from ClientLine,Processor Payout Batch,SET-20250101-ClientLine-Mastercard-USD,,0,0,0,204549.78,204549.78,204549.78,4102892.5200000005,4102892.5200000005,ACH,USD
2025-01-03,Settlement from ClientLine,Processor Payout Batch,SET-20250101-ClientLine-Visa-AUD,,0,0,0,29946.87,29946.87,29946.87,4132839.3900000006,4132839.3900000006,ACH,AUD
2025-01-03,Settlement from ClientLine,Processor Payout Batch,SET-20250101-ClientLine-Mastercard-CAD,,0,0,0,19439.54,19439.54,19439.54,4152278.9300000006,4152278.9300000006,ACH,CAD
2025-01-06,Settlement from ClientLine,Processor Payout Batch,SET-20250102-ClientLine-Visa-GBP,,0,0,0,29123.9,29123.9,29123.9,4181402.8300000005,4181402.8300000005,ACH,GBP
2025-01-06,Settlement from ClientLine,Processor Payout Batch,SET-20250102-ClientLine-Visa-USD,,0,0,0,169068.82,169068.82,169068.82,4350471.65,4350471.65,ACH,USD
2025-01-06,Settlement from GoCardless,Processor Payout Batch,SET-20250102-GoCardless-N/A-AUD,,0,0,0,56709.27,56709.27,56709.27,4407180.92,4407180.92,ACH,AUD
2025-01-06,Settlement from GoCardless,Processor Payout Batch,SET-20250102-GoCardless-N/A-CAD,,0,0,0,61868.45,61868.45,61868.45,4469049.37,4469049.37,ACH,CAD
2025-01-06,Settlement from GoCardless,Processor Payout Batch,SET-20250102-GoCardless-N/A-EUR,,0,0,0,144247.26,144247.26,144247.26,4613296.63,4613296.63,ACH,EUR
2025-01-06,Settlement from PayPal,Processor Payout Batch,SET-20250102-PayPal-N/A-AUD,,0,0,0,95108.5,95108.5,95108.5,4708405.13,4708405.13,ACH,AUD
2025-01-06,Settlement from GoCardless,Processor Payout Batch,SET-20250102-GoCardless-N/A-USD,,0,0,0,578576.09,578576.09,578576.09,5286981.22,5286981.22,ACH,USD
2025-01-06,Settlement from PayPal,Processor Payout Batch,SET-20250102-PayPal-N/A-CAD,,0,0,0,62753.41,62753.41,62753.41,5349734.63,5349734.63,ACH,CAD
2025-01-06,Settlement from PayPal,Processor Payout Batch,SET-20250102-PayPal-N/A-EUR,,0,0,0,103354.98,103354.98,103354.98,5453089.61,5453089.61,ACH,EUR
2025-01-06,Settlement from PayPal,Processor Payout Batch,SET-20250102-PayPal-N/A-GBP,,0,0,0,120299.52,120299.52,120299.52,5573389.13,5573389.13,ACH,GBP
2025-01-06,Settlement from GoCardless,Processor Payout Batch,SET-20250102-GoCardless-N/A-GBP,,0,0,0,78132.52,78132.52,78132.52,5651521.649999999,5651521.649999999,ACH,GBP
2025-01-06,Settlement from ClientLine,Processor Payout Batch,SET-20250102-ClientLine-Visa-EUR,,0,0,0,47759.48,47759.48,47759.48,5699281.13,5699281.13,ACH,EUR
2025-01-06,Settlement from PayPal,Processor Payout Batch,SET-20250102-PayPal-N/A-USD,,0,0,0,651192.52,651192.52,651192.52,6350473.65,6350473.65,ACH,USD
2025-01-06,Settlement from ClientLine,Processor Payout Batch,SET-20250102-ClientLine-Visa-AUD,,0,0,0,16249.06,16249.06,16249.06,6366722.71,6366722.71,ACH,AUD
2025-01-06,Settlement from ClientLine,Processor Payout Batch,SET-20250102-ClientLine-Mastercard-USD,,0,0,0,215214.9,215214.9,215214.9,6581937.61,6581937.61,ACH,USD
2025-01-06,Settlement from ClientLine,Processor Payout Batch,SET-20250102-ClientLine-Mastercard-GBP,,0,0,0,28124.12,28124.12,28124.12,6610061.73,6610061.73,ACH,GBP
2025-01-06,Settlement from ClientLine,Processor Payout Batch,SET-20250102-ClientLine-Mastercard-EUR,,0,0,0,34808.11,34808.11,34808.11,6644869.840000001,6644869.840000001,ACH,EUR
2025-01-06,Settlement from ClientLine,Processor Payout Batch,SET-20250102-ClientLine-Mastercard-CAD,,0,0,0,22359.36,22359.36,22359.36,6667229.200000001,6667229.200000001,ACH,CAD
2025-01-06,Settlement from ClientLine,Processor Payout Batch,SET-20250102-ClientLine-Mastercard-AUD,,0,0,0,36773.97,36773.97,36773.97,6704003.170000001,6704003.170000001,ACH,AUD
2025-01-06,Settlement from Amex,Processor Payout Batch,SET-20250102-Amex-Amex-USD,,0,0,0,204725.71,204725.71,204725.71,6908728.880000001,6908728.880000001,ACH,USD
2025-01-06,Settlement from Amex,Processor Payout Batch,SET-20250102-Amex-Amex-GBP,,0,0,0,35230.12,35230.12,35230.12,6943959.000000001,6943959.000000001,ACH,GBP
2025-01-06,Settlement from Amex,Processor Payout Batch,SET-20250102-Amex-Amex-EUR,,0,0,0,78207.61,78207.61,78207.61,7022166.610000001,7022166.610000001,ACH,EUR
2025-01-06,Settlement from Amex,Processor Payout Batch,SET-20250102-Amex-Amex-CAD,,0,0,0,21321.04,21321.04,21321.04,7043487.650000001,7043487.650000001,ACH,CAD
2025-01-06,Settlement from Amex,Processor Payout Batch,SET-20250102-Amex-Amex-AUD,,0,0,0,14587.53,14587.53,14587.53,7058075.180000002,7058075.180000002,ACH,AUD
2025-01-06,Settlement from ClientLine,Processor Payout Batch,SET-20250102-ClientLine-Visa-CAD,,0,0,0,12889.02,12889.02,12889.02,7070964.200000001,7070964.200000001,ACH,CAD
2025-01-07,Settlement from ClientLine,Processor Payout Batch,SET-20250103-ClientLine-Visa-USD,,0,0,0,180139.41,180139.41,180139.41,7251103.610000001,7251103.610000001,ACH,USD
2025-01-07,Settlement from GoCardless,Processor Payout Batch,SET-20250103-GoCardless-N/A-AUD,,0,0,0,95127.48,95127.48,95127.48,7346231.090000002,7346231.090000002,ACH,AUD
2025-01-07,Settlement from GoCardless,Processor Payout Batch,SET-20250103-GoCardless-N/A-CAD,,0,0,0,65943.45,65943.45,65943.45,7412174.540000002,7412174.540000002,ACH,CAD
2025-01-07,Settlement from GoCardless,Processor Payout Batch,SET-20250103-GoCardless-N/A-EUR,,0,0,0,161401.36,161401.36,161401.36,7573575.900000002,7573575.900000002,ACH,EUR
2025-01-07,Settlement from PayPal,Processor Payout Batch,SET-20250103-PayPal-N/A-USD,,0,0,0,612469.79,612469.79,612469.79,8186045.690000002,8186045.690000002,ACH,USD
2025-01-07,Settlement from PayPal,Processor Payout Batch,SET-20250103-PayPal-N/A-AUD,,0,0,0,73940.52,73940.52,73940.52,8259986.210000002,8259986.210000002,ACH,AUD
2025-01-07,Settlement from PayPal,Processor Payout Batch,SET-20250103-PayPal-N/A-CAD,,0,0,0,60384.38,60384.38,60384.38,8320370.590000002,8320370.590000002,ACH,CAD
2025-01-07,Settlement from PayPal,Processor Payout Batch,SET-20250103-PayPal-N/A-EUR,,0,0,0,102087.06,102087.06,102087.06,8422457.650000002,8422457.650000002,ACH,EUR
2025-01-07,Settlement from PayPal,Processor Payout Batch,SET-20250103-PayPal-N/A-GBP,,0,0,0,87041.03,87041.03,87041.03,8509498.680000002,8509498.680000002,ACH,GBP
2025-01-07,Settlement from ClientLine,Processor Payout Batch,SET-20250103-ClientLine-Visa-GBP,,0,0,0,46648.42,46648.42,46648.42,8556147.100000001,8556147.100000001,ACH,GBP
2025-01-07,Settlement from GoCardless,Processor Payout Batch,SET-20250103-GoCardless-N/A-USD,,0,0,0,685055.5,685055.5,685055.5,9241202.600000001,9241202.600000001,ACH,USD
2025-01-07,Settlement from ClientLine,Processor Payout Batch,SET-20250103-ClientLine-Visa-EUR,,0,0,0,51851.56,51851.56,51851.56,9293054.160000002,9293054.160000002,ACH,EUR
2025-01-07,Settlement from GoCardless,Processor Payout Batch,SET-20250103-GoCardless-N/A-GBP,,0,0,0,79347.07,79347.07,79347.07,9372401.230000002,9372401.230000002,ACH,GBP
2025-01-07,Settlement from ClientLine,Processor Payout Batch,SET-20250103-ClientLine-Visa-AUD,,0,0,0,27784.46,27784.46,27784.46,9400185.690000003,9400185.690000003,ACH,AUD
2025-01-07,Settlement from ClientLine,Processor Payout Batch,SET-20250103-ClientLine-Mastercard-USD,,0,0,0,240684.07,240684.07,240684.07,9640869.760000004,9640869.760000004,ACH,USD
2025-01-07,Settlement from ClientLine,Processor Payout Batch,SET-20250103-ClientLine-Mastercard-GBP,,0,0,0,38651.86,38651.86,38651.86,9679521.620000003,9679521.620000003,ACH,GBP
2025-01-07,Settlement from ClientLine,Processor Payout Batch,SET-20250103-ClientLine-Mastercard-EUR,,0,0,0,42735.08,42735.08,42735.08,9722256.700000003,9722256.700000003,ACH,EUR
2025-01-07,Settlement from ClientLine,Processor Payout Batch,SET-20250103-ClientLine-Mastercard-CAD,,0,0,0,17714.71,17714.71,17714.71,9739971.410000004,9739971.410000004,ACH,CAD
2025-01-07,Settlement from ClientLine,Processor Payout Batch,SET-20250103-ClientLine-Mastercard-AUD,,0,0,0,19063.47,19063.47,19063.47,9759034.880000005,9759034.880000005,ACH,AUD
2025-01-07,Settlement from Amex,Processor Payout Batch,SET-20250103-Amex-Amex-USD,,0,0,0,191073.66,191073.66,191073.66,9950108.540000005,9950108.540000005,ACH,USD
2025-01-07,Settlement from Amex,Processor Payout Batch,SET-20250103-Amex-Amex-GBP,,0,0,0,18141.66,18141.66,18141.66,9968250.200000005,9968250.200000005,ACH,GBP
2025-01-07,Settlement from Amex,Processor Payout Batch,SET-20250103-Amex-Amex-EUR,,0,0,0,70289.65,70289.65,70289.65,10038539.850000005,10038539.850000005,ACH,EUR
2025-01-07,Settlement from Amex,Processor Payout Batch,SET-20250103-Amex-Amex-CAD,,0,0,0,28610.27,28610.27,28610.27,10067150.120000005,10067150.120000005,ACH,CAD
2025-01-07,Settlement from Amex,Processor Payout Batch,SET-20250103-Amex-Amex-AUD,,0,0,0,18115.51,18115.51,18115.51,10085265.630000005,10085265.630000005,ACH,AUD
2025-01-07,Settlement from ClientLine,Processor Payout Batch,SET-20250103-ClientLine-Visa-CAD,,0,0,0,28830.7,28830.7,28830.7,10114096.330000004,10114096.330000004,ACH,CAD
2025-01-08,Settlement from ClientLine,Processor Payout Batch,SET-20250106-ClientLine-Visa-AUD,,0,0,0,19985.07,19985.07,19985.07,10134081.400000004,10134081.400000004,ACH,AUD
2025-01-08,Settlement from ClientLine,Processor Payout Batch,SET-20250106-ClientLine-Mastercard-USD,,0,0,0,187029.75,187029.75,187029.75,10321111.150000004,10321111.150000004,ACH,USD
2025-01-08,Settlement from ClientLine,Processor Payout Batch,SET-20250106-ClientLine-Mastercard-GBP,,0,0,0,21584.89,21584.89,21584.89,10342696.040000005,10342696.040000005,ACH,GBP
2025-01-08,Settlement from ClientLine,Processor Payout Batch,SET-20250106-ClientLine-Mastercard-EUR,,0,0,0,42774.57,42774.57,42774.57,10385470.610000005,10385470.610000005,ACH,EUR
2025-01-08,Settlement from Amex,Processor Payout Batch,SET-20250106-Amex-Amex-EUR,,0,0,0,61151.35,61151.35,61151.35,10446621.960000005,10446621.960000005,ACH,EUR
2025-01-08,Settlement from ClientLine,Processor Payout Batch,SET-20250106-ClientLine-Mastercard-AUD,,0,0,0,14488.77,14488.77,14488.77,10461110.730000004,10461110.730000004,ACH,AUD
2025-01-08,Settlement from Amex,Processor Payout Batch,SET-20250106-Amex-Amex-USD,,0,0,0,160757.9,160757.9,160757.9,10621868.630000005,10621868.630000005,ACH,USD
2025-01-08,Settlement from Amex,Processor Payout Batch,SET-20250106-Amex-Amex-GBP,,0,0,0,18716.19,18716.19,18716.19,10640584.820000004,10640584.820000004,ACH,GBP
2025-01-08,Settlement from ClientLine,Processor Payout Batch,SET-20250106-ClientLine-Visa-CAD,,0,0,0,26763.69,26763.69,26763.69,10667348.510000004,10667348.510000004,ACH,CAD
2025-01-08,Settlement from ClientLine,Processor Payout Batch,SET-20250106-ClientLine-Mastercard-CAD,,0,0,0,19756.87,19756.87,19756.87,10687105.380000003,10687105.380000003,ACH,CAD
2025-01-08,Settlement from ClientLine,Processor Payout Batch,SET-20250106-ClientLine-Visa-GBP,,0,0,0,36269.86,36269.86,36269.86,10723375.240000002,10723375.240000002,ACH,GBP
2025-01-08,Settlement from GoCardless,Processor Payout Batch,SET-20250106-GoCardless-N/A-USD,,0,0,0,654514.87,654514.87,654514.87,11377890.110000001,11377890.110000001,ACH,USD
2025-01-08,Settlement from GoCardless,Processor Payout Batch,SET-20250106-GoCardless-N/A-AUD,,0,0,0,76364.94,76364.94,76364.94,11454255.05,11454255.05,ACH,AUD
2025-01-08,Settlement from GoCardless,Processor Payout Batch,SET-20250106-GoCardless-N/A-CAD,,0,0,0,59824.5,59824.5,59824.5,11514079.55,11514079.55,ACH,CAD
2025-01-08,Settlement from GoCardless,Processor Payout Batch,SET-20250106-GoCardless-N/A-EUR,,0,0,0,159602.37,159602.37,159602.37,11673681.92,11673681.92,ACH,EUR
2025-01-08,Settlement from GoCardless,Processor Payout Batch,SET-20250106-GoCardless-N/A-GBP,,0,0,0,92801.14,92801.14,92801.14,11766483.06,11766483.06,ACH,GBP
2025-01-08,Settlement from PayPal,Processor Payout Batch,SET-20250106-PayPal-N/A-AUD,,0,0,0,96844.69,96844.69,96844.69,11863327.75,11863327.75,ACH,AUD
2025-01-08,Settlement from PayPal,Processor Payout Batch,SET-20250106-PayPal-N/A-CAD,,0,0,0,57504.65,57504.65,57504.65,11920832.4,11920832.4,ACH,CAD
2025-01-08,Settlement from PayPal,Processor Payout Batch,SET-20250106-PayPal-N/A-EUR,,0,0,0,133648.14,133648.14,133648.14,12054480.540000001,12054480.540000001,ACH,EUR
2025-01-08,Settlement from PayPal,Processor Payout Batch,SET-20250106-PayPal-N/A-GBP,,0,0,0,107583.23,107583.23,107583.23,12162063.770000001,12162063.770000001,ACH,GBP
2025-01-08,Settlement from PayPal,Processor Payout Batch,SET-20250106-PayPal-N/A-USD,,0,0,0,592518.85,592518.85,592518.85,12754582.620000001,12754582.620000001,ACH,USD
2025-01-08,Settlement from Amex,Processor Payout Batch,SET-20250106-Amex-Amex-CAD,,0,0,0,25488.24,25488.24,25488.24,12780070.860000001,12780070.860000001,ACH,CAD
2025-01-08,Settlement from ClientLine,Processor Payout Batch,SET-20250106-ClientLine-Visa-USD,,0,0,0,187510.6,187510.6,187510.6,12967581.46,12967581.46,ACH,USD
2025-01-08,Settlement from Amex,Processor Payout Batch,SET-20250106-Amex-Amex-AUD,,0,0,0,25498.55,25498.55,25498.55,12993080.010000002,12993080.010000002,ACH,AUD
2025-01-08,Settlement from ClientLine,Processor Payout Batch,SET-20250106-ClientLine-Visa-EUR,,0,0,0,65282.78,65282.78,65282.78,13058362.790000001,13058362.790000001,ACH,EUR
2025-01-08,Settlement from ClientLine,Processor Payout Batch,SET-20250104-ClientLine-Mastercard-CAD,,0,0,0,14366.75,14366.75,14366.75,13072729.540000001,13072729.540000001,ACH,CAD
2025-01-08,Settlement from PayPal,Processor Payout Batch,SET-20250104-PayPal-N/A-CAD,,0,0,0,102865.62,102865.62,102865.62,13175595.16,13175595.16,ACH,CAD
2025-01-08,Settlement from PayPal,Processor Payout Batch,SET-20250104-PayPal-N/A-AUD,,0,0,0,87198.66,87198.66,87198.66,13262793.82,13262793.82,ACH,AUD
2025-01-08,Settlement from GoCardless,Processor Payout Batch,SET-20250104-GoCardless-N/A-USD,,0,0,0,557973.39,557973.39,557973.39,13820767.21,13820767.21,ACH,USD
2025-01-08,Settlement from GoCardless,Processor Payout Batch,SET-20250104-GoCardless-N/A-GBP,,0,0,0,112534.0,112534.0,112534.0,13933301.21,13933301.21,ACH,GBP
2025-01-08,Settlement from GoCardless,Processor Payout Batch,SET-20250104-GoCardless-N/A-EUR,,0,0,0,174071.59,174071.59,174071.59,14107372.8,14107372.8,ACH,EUR
2025-01-08,Settlement from GoCardless,Processor Payout Batch,SET-20250104-GoCardless-N/A-CAD,,0,0,0,94056.24,94056.24,94056.24,14201429.040000001,14201429.040000001,ACH,CAD
2025-01-08,Settlement from GoCardless,Processor Payout Batch,SET-20250104-GoCardless-N/A-AUD,,0,0,0,70187.02,70187.02,70187.02,14271616.06,14271616.06,ACH,AUD
2025-01-08,Settlement from ClientLine,Processor Payout Batch,SET-20250104-ClientLine-Visa-USD,,0,0,0,244241.08,244241.08,244241.08,14515857.14,14515857.14,ACH,USD
2025-01-08,Settlement from ClientLine,Processor Payout Batch,SET-20250104-ClientLine-Visa-GBP,,0,0,0,38585.64,38585.64,38585.64,14554442.780000001,14554442.780000001,ACH,GBP
2025-01-08,Settlement from ClientLine,Processor Payout Batch,SET-20250104-ClientLine-Visa-EUR,,0,0,0,41478.1,41478.1,41478.1,14595920.88,14595920.88,ACH,EUR
2025-01-08,Settlement from ClientLine,Processor Payout Batch,SET-20250104-ClientLine-Visa-CAD,,0,0,0,16187.48,16187.48,16187.48,14612108.360000001,14612108.360000001,ACH,CAD
2025-01-08,Settlement from ClientLine,Processor Payout Batch,SET-20250104-ClientLine-Visa-AUD,,0,0,0,47189.43,47189.43,47189.43,14659297.790000001,14659297.790000001,ACH,AUD
2025-01-08,Settlement from ClientLine,Processor Payout Batch,SET-20250104-ClientLine-Mastercard-USD,,0,0,0,193788.74,193788.74,193788.74,14853086.530000001,14853086.530000001,ACH,USD
2025-01-08,Settlement from ClientLine,Processor Payout Batch,SET-20250104-ClientLine-Mastercard-GBP,,0,0,0,27981.86,27981.86,27981.86,14881068.39,14881068.39,ACH,GBP
2025-01-08,Settlement from ClientLine,Processor Payout Batch,SET-20250104-ClientLine-Mastercard-EUR,,0,0,0,61729.75,61729.75,61729.75,14942798.14,14942798.14,ACH,EUR
2025-01-08,Settlement from ClientLine,Processor Payout Batch,SET-20250104-ClientLine-Mastercard-AUD,,0,0,0,22722.75,22722.75,22722.75,14965520.89,14965520.89,ACH,AUD
2025-01-08,Settlement from Amex,Processor Payout Batch,SET-20250104-Amex-Amex-USD,,0,0,0,181180.9,181180.9,181180.9,15146701.790000001,15146701.790000001,ACH,USD
2025-01-08,Settlement from Amex,Processor Payout Batch,SET-20250104-Amex-Amex-GBP,,0,0,0,37399.46,37399.46,37399.46,15184101.250000002,15184101.250000002,ACH,GBP
2025-01-08,Settlement from Amex,Processor Payout Batch,SET-20250104-Amex-Amex-EUR,,0,0,0,58732.9,58732.9,58732.9,15242834.150000002,15242834.150000002,ACH,EUR
2025-01-08,Settlement from Amex,Processor Payout Batch,SET-20250104-Amex-Amex-CAD,,0,0,0,29410.49,29410.49,29410.49,15272244.640000002,15272244.640000002,ACH,CAD
2025-01-08,Settlement from Amex,Processor Payout Batch,SET-20250104-Amex-Amex-AUD,,0,0,0,33435.07,33435.07,33435.07,15305679.710000003,15305679.710000003,ACH,AUD
2025-01-08,Settlement from PayPal,Processor Payout Batch,SET-20250104-PayPal-N/A-EUR,,0,0,0,167368.35,167368.35,167368.35,15473048.060000002,15473048.060000002,ACH,EUR
2025-01-08,Settlement from PayPal,Processor Payout Batch,SET-20250104-PayPal-N/A-GBP,,0,0,0,99464.39,99464.39,99464.39,15572512.450000003,15572512.450000003,ACH,GBP
2025-01-08,Settlement from PayPal,Processor Payout Batch,SET-20250104-PayPal-N/A-USD,,0,0,0,652995.25,652995.25,652995.25,16225507.700000003,16225507.700000003,ACH,USD
2025-01-09,Settlement from PayPal,Processor Payout Batch,SET-20250105-PayPal-N/A-GBP,,0,0,0,114109.76,114109.76,114109.76,16339617.460000003,16339617.460000003,ACH,GBP
2025-01-09,Settlement from Amex,Processor Payout Batch,SET-20250107-Amex-Amex-GBP,,0,0,0,32624.7,32624.7,32624.7,16372242.160000002,16372242.160000002,ACH,GBP
2025-01-09,Settlement from Amex,Processor Payout Batch,SET-20250107-Amex-Amex-USD,,0,0,0,195218.11,195218.11,195218.11,16567460.270000001,16567460.270000001,ACH,USD
2025-01-09,Settlement from PayPal,Processor Payout Batch,SET-20250105-PayPal-N/A-USD,,0,0,0,601868.28,601868.28,601868.28,17169328.55,17169328.55,ACH,USD
2025-01-09,Settlement from ClientLine,Processor Payout Batch,SET-20250107-ClientLine-Mastercard-CAD,,0,0,0,19867.77,19867.77,19867.77,17189196.32,17189196.32,ACH,CAD
2025-01-09,Settlement from ClientLine,Processor Payout Batch,SET-20250107-ClientLine-Mastercard-EUR,,0,0,0,49139.2,49139.2,49139.2,17238335.52,17238335.52,ACH,EUR
2025-01-09,Settlement from ClientLine,Processor Payout Batch,SET-20250107-ClientLine-Mastercard-GBP,,0,0,0,18823.02,18823.02,18823.02,17257158.54,17257158.54,ACH,GBP
2025-01-09,Settlement from ClientLine,Processor Payout Batch,SET-20250107-ClientLine-Mastercard-USD,,0,0,0,254311.59,254311.59,254311.59,17511470.13,17511470.13,ACH,USD
2025-01-09,Settlement from ClientLine,Processor Payout Batch,SET-20250107-ClientLine-Visa-AUD,,0,0,0,40670.83,40670.83,40670.83,17552140.959999997,17552140.959999997,ACH,AUD
2025-01-09,Settlement from ClientLine,Processor Payout Batch,SET-20250107-ClientLine-Visa-CAD,,0,0,0,30791.85,30791.85,30791.85,17582932.81,17582932.81,ACH,CAD
2025-01-09,Settlement from ClientLine,Processor Payout Batch,SET-20250107-ClientLine-Visa-EUR,,0,0,0,42802.97,42802.97,42802.97,17625735.779999997,17625735.779999997,ACH,EUR
2025-01-09,Settlement from Amex,Processor Payout Batch,SET-20250107-Amex-Amex-EUR,,0,0,0,59994.36,59994.36,59994.36,17685730.139999997,17685730.139999997,ACH,EUR
2025-01-09,Settlement from ClientLine,Processor Payout Batch,SET-20250107-ClientLine-Visa-GBP,,0,0,0,33315.64,33315.64,33315.64,17719045.779999997,17719045.779999997,ACH,GBP
2025-01-09,Settlement from GoCardless,Processor Payout Batch,SET-20250107-GoCardless-N/A-AUD,,0,0,0,68750.0,68750.0,68750.0,17787795.779999997,17787795.779999997,ACH,AUD
2025-01-09,Settlement from GoCardless,Processor Payout Batch,SET-20250107-GoCardless-N/A-CAD,,0,0,0,50172.97,50172.97,50172.97,17837968.749999996,17837968.749999996,ACH,CAD
2025-01-09,Settlement from GoCardless,Processor Payout Batch,SET-20250107-GoCardless-N/A-EUR,,0,0,0,133031.94,133031.94,133031.94,17971000.689999998,17971000.689999998,ACH,EUR
2025-01-09,Settlement from GoCardless,Processor Payout Batch,SET-20250107-GoCardless-N/A-GBP,,0,0,0,92165.76,92165.76,92165.76,18063166.45,18063166.45,ACH,GBP
2025-01-09,Settlement from GoCardless,Processor Payout Batch,SET-20250107-GoCardless-N/A-USD,,0,0,0,660707.03,660707.03,660707.03,18723873.48,18723873.48,ACH,USD
2025-01-09,Settlement from PayPal,Processor Payout Batch,SET-20250107-PayPal-N/A-AUD,,0,0,0,81211.04,81211.04,81211.04,18805084.52,18805084.52,ACH,AUD
2025-01-09,Settlement from PayPal,Processor Payout Batch,SET-20250107-PayPal-N/A-CAD,,0,0,0,62283.23,62283.23,62283.23,18867367.75,18867367.75,ACH,CAD
2025-01-09,Settlement from PayPal,Processor Payout Batch,SET-20250107-PayPal-N/A-EUR,,0,0,0,157667.11,157667.11,157667.11,19025034.86,19025034.86,ACH,EUR
2025-01-09,Settlement from PayPal,Processor Payout Batch,SET-20250107-PayPal-N/A-GBP,,0,0,0,137471.08,137471.08,137471.08,19162505.939999998,19162505.939999998,ACH,GBP
2025-01-09,Settlement from PayPal,Processor Payout Batch,SET-20250107-PayPal-N/A-USD,,0,0,0,668909.9,668909.9,668909.9,19831415.839999996,19831415.839999996,ACH,USD
2025-01-09,Settlement from ClientLine,Processor Payout Batch,SET-20250107-ClientLine-Visa-USD,,0,0,0,214280.2,214280.2,214280.2,20045696.039999995,20045696.039999995,ACH,USD
2025-01-09,Settlement from Amex,Processor Payout Batch,SET-20250107-Amex-Amex-CAD,,0,0,0,21003.73,21003.73,21003.73,20066699.769999996,20066699.769999996,ACH,CAD
2025-01-09,Settlement from ClientLine,Processor Payout Batch,SET-20250107-ClientLine-Mastercard-AUD,,0,0,0,13056.34,13056.34,13056.34,20079756.109999996,20079756.109999996,ACH,AUD
2025-01-09,Settlement from Amex,Processor Payout Batch,SET-20250105-Amex-Amex-CAD,,0,0,0,12349.84,12349.84,12349.84,20092105.949999996,20092105.949999996,ACH,CAD
2025-01-09,Settlement from PayPal,Processor Payout Batch,SET-20250105-PayPal-N/A-EUR,,0,0,0,133888.57,133888.57,133888.57,20225994.519999996,20225994.519999996,ACH,EUR
2025-01-09,Settlement from PayPal,Processor Payout Batch,SET-20250105-PayPal-N/A-CAD,,0,0,0,59387.51,59387.51,59387.51,20285382.029999997,20285382.029999997,ACH,CAD
2025-01-09,Settlement from PayPal,Processor Payout Batch,SET-20250105-PayPal-N/A-AUD,,0,0,0,68055.56,68055.56,68055.56,20353437.589999996,20353437.589999996,ACH,AUD
2025-01-09,Settlement from GoCardless,Processor Payout Batch,SET-20250105-GoCardless-N/A-USD,,0,0,0,626927.82,626927.82,626927.82,20980365.409999996,20980365.409999996,ACH,USD
2025-01-09,Settlement from GoCardless,Processor Payout Batch,SET-20250105-GoCardless-N/A-GBP,,0,0,0,103535.49,103535.49,103535.49,21083900.899999995,21083900.899999995,ACH,GBP
2025-01-09,Settlement from GoCardless,Processor Payout Batch,SET-20250105-GoCardless-N/A-EUR,,0,0,0,154045.3,154045.3,154045.3,21237946.199999996,21237946.199999996,ACH,EUR
2025-01-09,Settlement from Amex,Processor Payout Batch,SET-20250107-Amex-Amex-AUD,,0,0,0,31260.95,31260.95,31260.95,21269207.149999995,21269207.149999995,ACH,AUD
2025-01-09,Settlement from GoCardless,Processor Payout Batch,SET-20250105-GoCardless-N/A-AUD,,0,0,0,89227.37,89227.37,89227.37,21358434.519999996,21358434.519999996,ACH,AUD
2025-01-09,Settlement from ClientLine,Processor Payout Batch,SET-20250105-ClientLine-Visa-USD,,0,0,0,206591.1,206591.1,206591.1,21565025.619999997,21565025.619999997,ACH,USD
2025-01-09,Settlement from ClientLine,Processor Payout Batch,SET-20250105-ClientLine-Visa-GBP,,0,0,0,31928.21,31928.21,31928.21,21596953.83,21596953.83,ACH,GBP
2025-01-09,Settlement from ClientLine,Processor Payout Batch,SET-20250105-ClientLine-Visa-EUR,,0,0,0,58971.74,58971.74,58971.74,21655925.569999997,21655925.569999997,ACH,EUR
2025-01-09,Settlement from GoCardless,Processor Payout Batch,SET-20250105-GoCardless-N/A-CAD,,0,0,0,70690.9,70690.9,70690.9,21726616.469999995,21726616.469999995,ACH,CAD
2025-01-09,Settlement from ClientLine,Processor Payout Batch,SET-20250105-ClientLine-Visa-CAD,,0,0,0,16529.42,16529.42,16529.42,21743145.889999997,21743145.889999997,ACH,CAD
2025-01-09,Settlement from Amex,Processor Payout Batch,SET-20250105-Amex-Amex-EUR,,0,0,0,44270.85,44270.85,44270.85,21787416.74,21787416.74,ACH,EUR
2025-01-09,Settlement from Amex,Processor Payout Batch,SET-20250105-Amex-Amex-GBP,,0,0,0,33570.59,33570.59,33570.59,21820987.33,21820987.33,ACH,GBP
2025-01-09,Settlement from Amex,Processor Payout Batch,SET-20250105-Amex-Amex-USD,,0,0,0,189862.64,189862.64,189862.64,22010849.97,22010849.97,ACH,USD
2025-01-09,Settlement from ClientLine,Processor Payout Batch,SET-20250105-ClientLine-Mastercard-AUD,,0,0,0,37653.7,37653.7,37653.7,22048503.669999998,22048503.669999998,ACH,AUD
2025-01-09,Settlement from ClientLine,Processor Payout Batch,SET-20250105-ClientLine-Mastercard-CAD,,0,0,0,11225.01,11225.01,11225.01,22059728.68,22059728.68,ACH,CAD
2025-01-09,Settlement from Amex,Processor Payout Batch,SET-20250105-Amex-Amex-AUD,,0,0,0,40567.6,40567.6,40567.6,22100296.28,22100296.28,ACH,AUD
2025-01-09,Settlement from ClientLine,Processor Payout Batch,SET-20250105-ClientLine-Mastercard-EUR,,0,0,0,31508.38,31508.38,31508.38,22131804.66,22131804.66,ACH,EUR
2025-01-09,Settlement from ClientLine,Processor Payout Batch,SET-20250105-ClientLine-Mastercard-GBP,,0,0,0,42909.58,42909.58,42909.58,22174714.24,22174714.24,ACH,GBP
2025-01-09,Settlement from ClientLine,Processor Payout Batch,SET-20250105-ClientLine-Mastercard-USD,,0,0,0,210932.14,210932.14,210932.14,22385646.38,22385646.38,ACH,USD
2025-01-09,Settlement from ClientLine,Processor Payout Batch,SET-20250105-ClientLine-Visa-AUD,,0,0,0,25900.63,25900.63,25900.63,22411547.009999998,22411547.009999998,ACH,AUD
2025-01-10,Settlement from PayPal,Processor Payout Batch,SET-20250108-PayPal-N/A-USD,,0,0,0,655488.06,655488.06,655488.06,23067035.069999997,23067035.069999997,ACH,USD
2025-01-10,Settlement from PayPal,Processor Payout Batch,SET-20250108-PayPal-N/A-EUR,,0,0,0,105841.38,105841.38,105841.38,23172876.449999996,23172876.449999996,ACH,EUR
2025-01-10,Settlement from PayPal,Processor Payout Batch,SET-20250108-PayPal-N/A-CAD,,0,0,0,71336.06,71336.06,71336.06,23244212.509999994,23244212.509999994,ACH,CAD
2025-01-10,Settlement from PayPal,Processor Payout Batch,SET-20250108-PayPal-N/A-AUD,,0,0,0,73770.75,73770.75,73770.75,23317983.259999994,23317983.259999994,ACH,AUD
2025-01-10,Settlement from GoCardless,Processor Payout Batch,SET-20250108-GoCardless-N/A-USD,,0,0,0,585048.53,585048.53,585048.53,23903031.789999995,23903031.789999995,ACH,USD
2025-01-10,Settlement from GoCardless,Processor Payout Batch,SET-20250108-GoCardless-N/A-GBP,,0,0,0,105343.65,105343.65,105343.65,24008375.439999994,24008375.439999994,ACH,GBP
2025-01-10,Settlement from GoCardless,Processor Payout Batch,SET-20250108-GoCardless-N/A-EUR,,0,0,0,106482.76,106482.76,106482.76,24114858.199999996,24114858.199999996,ACH,EUR
2025-01-10,Settlement from GoCardless,Processor Payout Batch,SET-20250108-GoCardless-N/A-CAD,,0,0,0,52982.68,52982.68,52982.68,24167840.879999995,24167840.879999995,ACH,CAD
2025-01-10,Settlement from GoCardless,Processor Payout Batch,SET-20250108-GoCardless-N/A-AUD,,0,0,0,66726.28,66726.28,66726.28,24234567.159999996,24234567.159999996,ACH,AUD
2025-01-10,Settlement from ClientLine,Processor Payout Batch,SET-20250108-ClientLine-Visa-USD,,0,0,0,191967.54,191967.54,191967.54,24426534.699999996,24426534.699999996,ACH,USD
2025-01-10,Settlement from ClientLine,Processor Payout Batch,SET-20250108-ClientLine-Visa-GBP,,0,0,0,23713.03,23713.03,23713.03,24450247.729999997,24450247.729999997,ACH,GBP
2025-01-10,Settlement from PayPal,Processor Payout Batch,SET-20250108-PayPal-N/A-GBP,,0,0,0,81835.33,81835.33,81835.33,24532083.059999995,24532083.059999995,ACH,GBP
2025-01-10,Settlement from ClientLine,Processor Payout Batch,SET-20250108-ClientLine-Visa-EUR,,0,0,0,50969.07,50969.07,50969.07,24583052.129999995,24583052.129999995,ACH,EUR
2025-01-10,Settlement from ClientLine,Processor Payout Batch,SET-20250108-ClientLine-Visa-AUD,,0,0,0,19656.1,19656.1,19656.1,24602708.229999997,24602708.229999997,ACH,AUD
2025-01-10,Settlement from Amex,Processor Payout Batch,SET-20250108-Amex-Amex-AUD,,0,0,0,39464.79,39464.79,39464.79,24642173.019999996,24642173.019999996,ACH,AUD
2025-01-10,Settlement from Amex,Processor Payout Batch,SET-20250108-Amex-Amex-CAD,,0,0,0,23109.76,23109.76,23109.76,24665282.779999997,24665282.779999997,ACH,CAD
2025-01-10,Settlement from Amex,Processor Payout Batch,SET-20250108-Amex-Amex-EUR,,0,0,0,44191.37,44191.37,44191.37,24709474.15,24709474.15,ACH,EUR
2025-01-10,Settlement from Amex,Processor Payout Batch,SET-20250108-Amex-Amex-GBP,,0,0,0,35692.65,35692.65,35692.65,24745166.799999997,24745166.799999997,ACH,GBP
2025-01-10,Settlement from Amex,Processor Payout Batch,SET-20250108-Amex-Amex-USD,,0,0,0,219342.97,219342.97,219342.97,24964509.769999996,24964509.769999996,ACH,USD
2025-01-10,Settlement from ClientLine,Processor Payout Batch,SET-20250108-ClientLine-Visa-CAD,,0,0,0,36056.57,36056.57,36056.57,25000566.339999996,25000566.339999996,ACH,CAD
2025-01-10,Settlement from ClientLine,Processor Payout Batch,SET-20250108-ClientLine-Mastercard-CAD,,0,0,0,12305.72,12305.72,12305.72,25012872.059999995,25012872.059999995,ACH,CAD
2025-01-10,Settlement from ClientLine,Processor Payout Batch,SET-20250108-ClientLine-Mastercard-EUR,,0,0,0,61304.71,61304.71,61304.71,25074176.769999996,25074176.769999996,ACH,EUR
2025-01-10,Settlement from ClientLine,Processor Payout Batch,SET-20250108-ClientLine-Mastercard-GBP,,0,0,0,47329.31,47329.31,47329.31,25121506.079999994,25121506.079999994,ACH,GBP
2025-01-10,Settlement from ClientLine,Processor Payout Batch,SET-20250108-ClientLine-Mastercard-USD,,0,0,0,165560.68,165560.68,165560.68,25287066.759999994,25287066.759999994,ACH,USD
2025-01-10,Settlement from ClientLine,Processor Payout Batch,SET-20250108-ClientLine-Mastercard-AUD,,0,0,0,15823.68,15823.68,15823.68,25302890.439999994,25302890.439999994,ACH,AUD
2025-01-13,Settlement from GoCardless,Processor Payout Batch,SET-20250109-GoCardless-N/A-AUD,,0,0,0,95354.15,95354.15,95354.15,25398244.589999992,25398244.589999992,ACH,AUD
2025-01-13,Settlement from GoCardless,Processor Payout Batch,SET-20250109-GoCardless-N/A-CAD,,0,0,0,50197.26,50197.26,50197.26,25448441.849999994,25448441.849999994,ACH,CAD
2025-01-13,Settlement from GoCardless,Processor Payout Batch,SET-20250109-GoCardless-N/A-EUR,,0,0,0,162838.35,162838.35,162838.35,25611280.199999996,25611280.199999996,ACH,EUR
2025-01-13,Settlement from GoCardless,Processor Payout Batch,SET-20250109-GoCardless-N/A-GBP,,0,0,0,113579.55,113579.55,113579.55,25724859.749999996,25724859.749999996,ACH,GBP
2025-01-13,Settlement from GoCardless,Processor Payout Batch,SET-20250109-GoCardless-N/A-USD,,0,0,0,606252.26,606252.26,606252.26,26331112.009999998,26331112.009999998,ACH,USD
2025-01-13,Settlement from PayPal,Processor Payout Batch,SET-20250109-PayPal-N/A-CAD,,0,0,0,60923.43,60923.43,60923.43,26392035.439999998,26392035.439999998,ACH,CAD
2025-01-13,Settlement from PayPal,Processor Payout Batch,SET-20250109-PayPal-N/A-EUR,,0,0,0,143027.68,143027.68,143027.68,26535063.119999997,26535063.119999997,ACH,EUR
2025-01-13,Settlement from PayPal,Processor Payout Batch,SET-20250109-PayPal-N/A-GBP,,0,0,0,94523.37,94523.37,94523.37,26629586.49,26629586.49,ACH,GBP
2025-01-13,Settlement from PayPal,Processor Payout Batch,SET-20250109-PayPal-N/A-USD,,0,0,0,639508.65,639508.65,639508.65,27269095.139999997,27269095.139999997,ACH,USD
2025-01-13,Settlement from ClientLine,Processor Payout Batch,SET-20250109-ClientLine-Visa-USD,,0,0,0,167089.88,167089.88,167089.88,27436185.019999996,27436185.019999996,ACH,USD
2025-01-13,Settlement from PayPal,Processor Payout Batch,SET-20250109-PayPal-N/A-AUD,,0,0,0,71227.45,71227.45,71227.45,27507412.469999995,27507412.469999995,ACH,AUD
2025-01-13,Settlement from ClientLine,Processor Payout Batch,SET-20250109-ClientLine-Visa-GBP,,0,0,0,35709.79,35709.79,35709.79,27543122.259999994,27543122.259999994,ACH,GBP
2025-01-13,Settlement from ClientLine,Processor Payout Batch,SET-20250109-ClientLine-Visa-EUR,,0,0,0,90208.32,90208.32,90208.32,27633330.579999994,27633330.579999994,ACH,EUR
2025-01-13,Settlement from ClientLine,Processor Payout Batch,SET-20250109-ClientLine-Visa-CAD,,0,0,0,28251.27,28251.27,28251.27,27661581.849999994,27661581.849999994,ACH,CAD
2025-01-13,Settlement from Amex,Processor Payout Batch,SET-20250109-Amex-Amex-CAD,,0,0,0,19520.08,19520.08,19520.08,27681101.929999992,27681101.929999992,ACH,CAD
2025-01-13,Settlement from Amex,Processor Payout Batch,SET-20250109-Amex-Amex-EUR,,0,0,0,51479.22,51479.22,51479.22,27732581.14999999,27732581.14999999,ACH,EUR
2025-01-13,Settlement from Amex,Processor Payout Batch,SET-20250109-Amex-Amex-GBP,,0,0,0,33912.65,33912.65,33912.65,27766493.79999999,27766493.79999999,ACH,GBP
2025-01-13,Settlement from Amex,Processor Payout Batch,SET-20250109-Amex-Amex-USD,,0,0,0,181233.94,181233.94,181233.94,27947727.73999999,27947727.73999999,ACH,USD
2025-01-13,Settlement from ClientLine,Processor Payout Batch,SET-20250109-ClientLine-Mastercard-AUD,,0,0,0,34084.08,34084.08,34084.08,27981811.81999999,27981811.81999999,ACH,AUD
2025-01-13,Settlement from Amex,Processor Payout Batch,SET-20250109-Amex-Amex-AUD,,0,0,0,29998.41,29998.41,29998.41,28011810.22999999,28011810.22999999,ACH,AUD
2025-01-13,Settlement from ClientLine,Processor Payout Batch,SET-20250109-ClientLine-Mastercard-EUR,,0,0,0,42769.47,42769.47,42769.47,28054579.699999988,28054579.699999988,ACH,EUR
2025-01-13,Settlement from ClientLine,Processor Payout Batch,SET-20250109-ClientLine-Mastercard-GBP,,0,0,0,15489.24,15489.24,15489.24,28070068.939999986,28070068.939999986,ACH,GBP
2025-01-13,Settlement from ClientLine,Processor Payout Batch,SET-20250109-ClientLine-Mastercard-USD,,0,0,0,270039.08,270039.08,270039.08,28340108.019999985,28340108.019999985,ACH,USD
2025-01-13,Settlement from ClientLine,Processor Payout Batch,SET-20250109-ClientLine-Visa-AUD,,0,0,0,23289.24,23289.24,23289.24,28363397.259999983,28363397.259999983,ACH,AUD
2025-01-13,Settlement from ClientLine,Processor Payout Batch,SET-20250109-ClientLine-Mastercard-CAD,,0,0,0,21223.98,21223.98,21223.98,28384621.239999983,28384621.239999983,ACH,CAD
2025-01-14,Settlement from GoCardless,Processor Payout Batch,SET-20250110-GoCardless-N/A-AUD,,0,0,0,69169.25,69169.25,69169.25,28453790.489999983,28453790.489999983,ACH,AUD
2025-01-14,Settlement from GoCardless,Processor Payout Batch,SET-20250110-GoCardless-N/A-CAD,,0,0,0,52261.91,52261.91,52261.91,28506052.399999984,28506052.399999984,ACH,CAD
2025-01-14,Settlement from GoCardless,Processor Payout Batch,SET-20250110-GoCardless-N/A-EUR,,0,0,0,137572.99,137572.99,137572.99,28643625.389999982,28643625.389999982,ACH,EUR
2025-01-14,Settlement from PayPal,Processor Payout Batch,SET-20250110-PayPal-N/A-USD,,0,0,0,700747.49,700747.49,700747.49,29344372.87999998,29344372.87999998,ACH,USD
2025-01-14,Settlement from GoCardless,Processor Payout Batch,SET-20250110-GoCardless-N/A-GBP,,0,0,0,124043.24,124043.24,124043.24,29468416.11999998,29468416.11999998,ACH,GBP
2025-01-14,Settlement from PayPal,Processor Payout Batch,SET-20250110-PayPal-N/A-AUD,,0,0,0,68144.2,68144.2,68144.2,29536560.319999978,29536560.319999978,ACH,AUD
2025-01-14,Settlement from PayPal,Processor Payout Batch,SET-20250110-PayPal-N/A-CAD,,0,0,0,53689.56,53689.56,53689.56,29590249.879999977,29590249.879999977,ACH,CAD
2025-01-14,Settlement from PayPal,Processor Payout Batch,SET-20250110-PayPal-N/A-EUR,,0,0,0,143113.14,143113.14,143113.14,29733363.019999977,29733363.019999977,ACH,EUR
2025-01-14,Settlement from PayPal,Processor Payout Batch,SET-20250110-PayPal-N/A-GBP,,0,0,0,91070.42,91070.42,91070.42,29824433.43999998,29824433.43999998,ACH,GBP
2025-01-14,Settlement from ClientLine,Processor Payout Batch,SET-20250110-ClientLine-Visa-USD,,0,0,0,184235.15,184235.15,184235.15,30008668.589999977,30008668.589999977,ACH,USD
2025-01-14,Settlement from GoCardless,Processor Payout Batch,SET-20250110-GoCardless-N/A-USD,,0,0,0,621022.33,621022.33,621022.33,30629690.919999976,30629690.919999976,ACH,USD
2025-01-14,Settlement from ClientLine,Processor Payout Batch,SET-20250110-ClientLine-Visa-GBP,,0,0,0,42220.05,42220.05,42220.05,30671910.969999976,30671910.969999976,ACH,GBP
2025-01-14,Settlement from ClientLine,Processor Payout Batch,SET-20250110-ClientLine-Mastercard-CAD,,0,0,0,6537.55,6537.55,6537.55,30678448.519999977,30678448.519999977,ACH,CAD
2025-01-14,Settlement from ClientLine,Processor Payout Batch,SET-20250110-ClientLine-Visa-CAD,,0,0,0,36308.83,36308.83,36308.83,30714757.349999975,30714757.349999975,ACH,CAD
2025-01-14,Settlement from ClientLine,Processor Payout Batch,SET-20250110-ClientLine-Visa-AUD,,0,0,0,18183.16,18183.16,18183.16,30732940.509999976,30732940.509999976,ACH,AUD
2025-01-14,Settlement from ClientLine,Processor Payout Batch,SET-20250110-ClientLine-Mastercard-USD,,0,0,0,219595.35,219595.35,219595.35,30952535.859999977,30952535.859999977,ACH,USD
2025-01-14,Settlement from ClientLine,Processor Payout Batch,SET-20250110-ClientLine-Mastercard-GBP,,0,0,0,25454.9,25454.9,25454.9,30977990.759999976,30977990.759999976,ACH,GBP
2025-01-14,Settlement from ClientLine,Processor Payout Batch,SET-20250110-ClientLine-Mastercard-EUR,,0,0,0,47156.34,47156.34,47156.34,31025147.099999975,31025147.099999975,ACH,EUR
2025-01-14,Settlement from ClientLine,Processor Payout Batch,SET-20250110-ClientLine-Mastercard-AUD,,0,0,0,7395.72,7395.72,7395.72,31032542.819999974,31032542.819999974,ACH,AUD
2025-01-14,Settlement from Amex,Processor Payout Batch,SET-20250110-Amex-Amex-USD,,0,0,0,211435.38,211435.38,211435.38,31243978.199999973,31243978.199999973,ACH,USD
2025-01-14,Settlement from Amex,Processor Payout Batch,SET-20250110-Amex-Amex-GBP,,0,0,0,18084.48,18084.48,18084.48,31262062.679999974,31262062.679999974,ACH,GBP
2025-01-14,Settlement from Amex,Processor Payout Batch,SET-20250110-Amex-Amex-EUR,,0,0,0,36020.49,36020.49,36020.49,31298083.169999972,31298083.169999972,ACH,EUR
2025-01-14,Settlement from Amex,Processor Payout Batch,SET-20250110-Amex-Amex-CAD,,0,0,0,38113.61,38113.61,38113.61,31336196.77999997,31336196.77999997,ACH,CAD
2025-01-14,Settlement from Amex,Processor Payout Batch,SET-20250110-Amex-Amex-AUD,,0,0,0,41243.91,41243.91,41243.91,31377440.68999997,31377440.68999997,ACH,AUD
2025-01-14,Settlement from ClientLine,Processor Payout Batch,SET-20250110-ClientLine-Visa-EUR,,0,0,0,53018.03,53018.03,53018.03,31430458.719999973,31430458.719999973,ACH,EUR
2025-01-15,Settlement from ClientLine,Processor Payout Batch,SET-20250113-ClientLine-Visa-AUD,,0,0,0,24174.67,24174.67,24174.67,31454633.389999975,31454633.389999975,ACH,AUD
2025-01-15,Settlement from ClientLine,Processor Payout Batch,SET-20250113-ClientLine-Mastercard-USD,,0,0,0,227215.79,227215.79,227215.79,31681849.179999974,31681849.179999974,ACH,USD
2025-01-15,Settlement from ClientLine,Processor Payout Batch,SET-20250113-ClientLine-Mastercard-GBP,,0,0,0,36203.46,36203.46,36203.46,31718052.639999975,31718052.639999975,ACH,GBP
2025-01-15,Settlement from ClientLine,Processor Payout Batch,SET-20250113-ClientLine-Mastercard-EUR,,0,0,0,48151.09,48151.09,48151.09,31766203.729999974,31766203.729999974,ACH,EUR
2025-01-15,Settlement from Amex,Processor Payout Batch,SET-20250113-Amex-Amex-EUR,,0,0,0,55576.78,55576.78,55576.78,31821780.509999976,31821780.509999976,ACH,EUR
2025-01-15,Settlement from ClientLine,Processor Payout Batch,SET-20250113-ClientLine-Mastercard-AUD,,0,0,0,28472.31,28472.31,28472.31,31850252.819999974,31850252.819999974,ACH,AUD
2025-01-15,Settlement from Amex,Processor Payout Batch,SET-20250113-Amex-Amex-USD,,0,0,0,205035.74,205035.74,205035.74,32055288.559999973,32055288.559999973,ACH,USD
2025-01-15,Settlement from Amex,Processor Payout Batch,SET-20250113-Amex-Amex-GBP,,0,0,0,13519.14,13519.14,13519.14,32068807.699999973,32068807.699999973,ACH,GBP
2025-01-15,Settlement from ClientLine,Processor Payout Batch,SET-20250113-ClientLine-Visa-CAD,,0,0,0,37776.03,37776.03,37776.03,32106583.729999974,32106583.729999974,ACH,CAD
2025-01-15,Settlement from ClientLine,Processor Payout Batch,SET-20250113-ClientLine-Mastercard-CAD,,0,0,0,37309.5,37309.5,37309.5,32143893.229999974,32143893.229999974,ACH,CAD
2025-01-15,Settlement from ClientLine,Processor Payout Batch,SET-20250113-ClientLine-Visa-EUR,,0,0,0,41994.46,41994.46,41994.46,32185887.689999975,32185887.689999975,ACH,EUR
2025-01-15,Settlement from GoCardless,Processor Payout Batch,SET-20250113-GoCardless-N/A-GBP,,0,0,0,97952.99,97952.99,97952.99,32283840.679999974,32283840.679999974,ACH,GBP
2025-01-15,Settlement from ClientLine,Processor Payout Batch,SET-20250113-ClientLine-Visa-USD,,0,0,0,164589.02,164589.02,164589.02,32448429.699999973,32448429.699999973,ACH,USD
2025-01-15,Settlement from GoCardless,Processor Payout Batch,SET-20250113-GoCardless-N/A-AUD,,0,0,0,74175.92,74175.92,74175.92,32522605.619999975,32522605.619999975,ACH,AUD
2025-01-15,Settlement from GoCardless,Processor Payout Batch,SET-20250113-GoCardless-N/A-CAD,,0,0,0,74837.73,74837.73,74837.73,32597443.349999975,32597443.349999975,ACH,CAD
2025-01-15,Settlement from GoCardless,Processor Payout Batch,SET-20250113-GoCardless-N/A-EUR,,0,0,0,135623.01,135623.01,135623.01,32733066.359999977,32733066.359999977,ACH,EUR
2025-01-15,Settlement from GoCardless,Processor Payout Batch,SET-20250113-GoCardless-N/A-USD,,0,0,0,635292.17,635292.17,635292.17,33368358.52999998,33368358.52999998,ACH,USD
2025-01-15,Settlement from PayPal,Processor Payout Batch,SET-20250113-PayPal-N/A-AUD,,0,0,0,88069.62,88069.62,88069.62,33456428.14999998,33456428.14999998,ACH,AUD
2025-01-15,Settlement from PayPal,Processor Payout Batch,SET-20250113-PayPal-N/A-CAD,,0,0,0,72906.34,72906.34,72906.34,33529334.48999998,33529334.48999998,ACH,CAD
2025-01-15,Settlement from PayPal,Processor Payout Batch,SET-20250113-PayPal-N/A-EUR,,0,0,0,196103.52,196103.52,196103.52,33725438.00999998,33725438.00999998,ACH,EUR
2025-01-15,Settlement from PayPal,Processor Payout Batch,SET-20250113-PayPal-N/A-GBP,,0,0,0,123682.5,123682.5,123682.5,33849120.50999998,33849120.50999998,ACH,GBP
2025-01-15,Settlement from PayPal,Processor Payout Batch,SET-20250113-PayPal-N/A-USD,,0,0,0,621400.26,621400.26,621400.26,34470520.76999998,34470520.76999998,ACH,USD
2025-01-15,Settlement from Amex,Processor Payout Batch,SET-20250113-Amex-Amex-CAD,,0,0,0,5028.22,5028.22,5028.22,34475548.98999998,34475548.98999998,ACH,CAD
2025-01-15,Settlement from ClientLine,Processor Payout Batch,SET-20250113-ClientLine-Visa-GBP,,0,0,0,54430.7,54430.7,54430.7,34529979.68999998,34529979.68999998,ACH,GBP
2025-01-15,Settlement from Amex,Processor Payout Batch,SET-20250113-Amex-Amex-AUD,,0,0,0,38228.84,38228.84,38228.84,34568208.52999999,34568208.52999999,ACH,AUD
2025-01-15,Settlement from GoCardless,Processor Payout Batch,SET-20250111-GoCardless-N/A-GBP,,0,0,0,84594.67,84594.67,84594.67,34652803.19999999,34652803.19999999,ACH,GBP
2025-01-15,Settlement from PayPal,Processor Payout Batch,SET-20250111-PayPal-N/A-USD,,0,0,0,571242.24,571242.24,571242.24,35224045.43999999,35224045.43999999,ACH,USD
2025-01-15,Settlement from PayPal,Processor Payout Batch,SET-20250111-PayPal-N/A-EUR,,0,0,0,125459.62,125459.62,125459.62,35349505.05999999,35349505.05999999,ACH,EUR
2025-01-15,Settlement from PayPal,Processor Payout Batch,SET-20250111-PayPal-N/A-CAD,,0,0,0,62268.13,62268.13,62268.13,35411773.18999999,35411773.18999999,ACH,CAD
2025-01-15,Settlement from PayPal,Processor Payout Batch,SET-20250111-PayPal-N/A-AUD,,0,0,0,73610.12,73610.12,73610.12,35485383.30999999,35485383.30999999,ACH,AUD
2025-01-15,Settlement from GoCardless,Processor Payout Batch,SET-20250111-GoCardless-N/A-USD,,0,0,0,590438.83,590438.83,590438.83,36075822.139999986,36075822.139999986,ACH,USD
2025-01-15,Settlement from GoCardless,Processor Payout Batch,SET-20250111-GoCardless-N/A-EUR,,0,0,0,158582.3,158582.3,158582.3,36234404.43999998,36234404.43999998,ACH,EUR
2025-01-15,Settlement from GoCardless,Processor Payout Batch,SET-20250111-GoCardless-N/A-CAD,,0,0,0,80502.97,80502.97,80502.97,36314907.40999998,36314907.40999998,ACH,CAD
2025-01-15,Settlement from GoCardless,Processor Payout Batch,SET-20250111-GoCardless-N/A-AUD,,0,0,0,66253.49,66253.49,66253.49,36381160.89999998,36381160.89999998,ACH,AUD
2025-01-15,Settlement from ClientLine,Processor Payout Batch,SET-20250111-ClientLine-Visa-USD,,0,0,0,184281.31,184281.31,184281.31,36565442.209999986,36565442.209999986,ACH,USD
2025-01-15,Settlement from ClientLine,Processor Payout Batch,SET-20250111-ClientLine-Visa-GBP,,0,0,0,26302.85,26302.85,26302.85,36591745.05999999,36591745.05999999,ACH,GBP
2025-01-15,Settlement from PayPal,Processor Payout Batch,SET-20250111-PayPal-N/A-GBP,,0,0,0,92139.97,92139.97,92139.97,36683885.02999999,36683885.02999999,ACH,GBP
2025-01-15,Settlement from ClientLine,Processor Payout Batch,SET-20250111-ClientLine-Visa-EUR,,0,0,0,62075.07,62075.07,62075.07,36745960.09999999,36745960.09999999,ACH,EUR
2025-01-15,Settlement from ClientLine,Processor Payout Batch,SET-20250111-ClientLine-Visa-AUD,,0,0,0,37163.63,37163.63,37163.63,36783123.72999999,36783123.72999999,ACH,AUD
2025-01-15,Settlement from ClientLine,Processor Payout Batch,SET-20250111-ClientLine-Mastercard-USD,,0,0,0,250174.79,250174.79,250174.79,37033298.51999999,37033298.51999999,ACH,USD
2025-01-15,Settlement from ClientLine,Processor Payout Batch,SET-20250111-ClientLine-Mastercard-GBP,,0,0,0,42288.46,42288.46,42288.46,37075586.97999999,37075586.97999999,ACH,GBP
2025-01-15,Settlement from ClientLine,Processor Payout Batch,SET-20250111-ClientLine-Mastercard-EUR,,0,0,0,50861.57,50861.57,50861.57,37126448.54999999,37126448.54999999,ACH,EUR
2025-01-15,Settlement from ClientLine,Processor Payout Batch,SET-20250111-ClientLine-Mastercard-CAD,,0,0,0,31054.37,31054.37,31054.37,37157502.91999999,37157502.91999999,ACH,CAD
2025-01-15,Settlement from ClientLine,Processor Payout Batch,SET-20250111-ClientLine-Mastercard-AUD,,0,0,0,42975.22,42975.22,42975.22,37200478.139999986,37200478.139999986,ACH,AUD
2025-01-15,Settlement from Amex,Processor Payout Batch,SET-20250111-Amex-Amex-USD,,0,0,0,201733.43,201733.43,201733.43,37402211.569999985,37402211.569999985,ACH,USD
2025-01-15,Settlement from Amex,Processor Payout Batch,SET-20250111-Amex-Amex-GBP,,0,0,0,36436.32,36436.32,36436.32,37438647.889999986,37438647.889999986,ACH,GBP
2025-01-15,Settlement from Amex,Processor Payout Batch,SET-20250111-Amex-Amex-EUR,,0,0,0,35834.57,35834.57,35834.57,37474482.459999986,37474482.459999986,ACH,EUR
2025-01-15,Settlement from ClientLine,Processor Payout Batch,SET-20250111-ClientLine-Visa-CAD,,0,0,0,17935.48,17935.48,17935.48,37492417.93999998,37492417.93999998,ACH,CAD
2025-01-15,Settlement from Amex,Processor Payout Batch,SET-20250111-Amex-Amex-CAD,,0,0,0,30098.08,30098.08,30098.08,37522516.01999998,37522516.01999998,ACH,CAD
2025-01-15,Settlement from Amex,Processor Payout Batch,SET-20250111-Amex-Amex-AUD,,0,0,0,26946.47,26946.47,26946.47,37549462.48999998,37549462.48999998,ACH,AUD
2025-01-16,Settlement from Amex,Processor Payout Batch,SET-20250114-Amex-Amex-GBP,,0,0,0,29278.66,29278.66,29278.66,37578741.149999976,37578741.149999976,ACH,GBP
2025-01-16,Settlement from Amex,Processor Payout Batch,SET-20250112-Amex-Amex-AUD,,0,0,0,26847.29,26847.29,26847.29,37605588.439999975,37605588.439999975,ACH,AUD
2025-01-16,Settlement from PayPal,Processor Payout Batch,SET-20250114-PayPal-N/A-USD,,0,0,0,602293.92,602293.92,602293.92,38207882.35999998,38207882.35999998,ACH,USD
2025-01-16,Settlement from PayPal,Processor Payout Batch,SET-20250114-PayPal-N/A-GBP,,0,0,0,99557.69,99557.69,99557.69,38307440.049999975,38307440.049999975,ACH,GBP
2025-01-16,Settlement from PayPal,Processor Payout Batch,SET-20250114-PayPal-N/A-EUR,,0,0,0,172318.79,172318.79,172318.79,38479758.839999974,38479758.839999974,ACH,EUR
2025-01-16,Settlement from PayPal,Processor Payout Batch,SET-20250114-PayPal-N/A-CAD,,0,0,0,78824.71,78824.71,78824.71,38558583.549999975,38558583.549999975,ACH,CAD
2025-01-16,Settlement from PayPal,Processor Payout Batch,SET-20250114-PayPal-N/A-AUD,,0,0,0,66562.6,66562.6,66562.6,38625146.149999976,38625146.149999976,ACH,AUD
2025-01-16,Settlement from GoCardless,Processor Payout Batch,SET-20250114-GoCardless-N/A-USD,,0,0,0,668710.03,668710.03,668710.03,39293856.17999998,39293856.17999998,ACH,USD
2025-01-16,Settlement from GoCardless,Processor Payout Batch,SET-20250114-GoCardless-N/A-EUR,,0,0,0,161849.33,161849.33,161849.33,39455705.509999976,39455705.509999976,ACH,EUR
2025-01-16,Settlement from GoCardless,Processor Payout Batch,SET-20250114-GoCardless-N/A-CAD,,0,0,0,82746.9,82746.9,82746.9,39538452.409999974,39538452.409999974,ACH,CAD
2025-01-16,Settlement from GoCardless,Processor Payout Batch,SET-20250114-GoCardless-N/A-AUD,,0,0,0,75983.88,75983.88,75983.88,39614436.28999998,39614436.28999998,ACH,AUD
2025-01-16,Settlement from Amex,Processor Payout Batch,SET-20250114-Amex-Amex-EUR,,0,0,0,43516.25,43516.25,43516.25,39657952.53999998,39657952.53999998,ACH,EUR
2025-01-16,Settlement from ClientLine,Processor Payout Batch,SET-20250114-ClientLine-Visa-USD,,0,0,0,199211.48,199211.48,199211.48,39857164.01999997,39857164.01999997,ACH,USD
2025-01-16,Settlement from ClientLine,Processor Payout Batch,SET-20250114-ClientLine-Visa-EUR,,0,0,0,42453.64,42453.64,42453.64,39899617.659999974,39899617.659999974,ACH,EUR
2025-01-16,Settlement from ClientLine,Processor Payout Batch,SET-20250114-ClientLine-Visa-CAD,,0,0,0,27240.62,27240.62,27240.62,39926858.27999997,39926858.27999997,ACH,CAD
2025-01-16,Settlement from ClientLine,Processor Payout Batch,SET-20250114-ClientLine-Visa-AUD,,0,0,0,29791.56,29791.56,29791.56,39956649.839999974,39956649.839999974,ACH,AUD
2025-01-16,Settlement from ClientLine,Processor Payout Batch,SET-20250114-ClientLine-Mastercard-USD,,0,0,0,227174.0,227174.0,227174.0,40183823.839999974,40183823.839999974,ACH,USD
2025-01-16,Settlement from Amex,Processor Payout Batch,SET-20250114-Amex-Amex-CAD,,0,0,0,16393.13,16393.13,16393.13,40200216.96999998,40200216.96999998,ACH,CAD
2025-01-16,Settlement from ClientLine,Processor Payout Batch,SET-20250114-ClientLine-Mastercard-GBP,,0,0,0,26012.01,26012.01,26012.01,40226228.979999974,40226228.979999974,ACH,GBP
2025-01-16,Settlement from ClientLine,Processor Payout Batch,SET-20250114-ClientLine-Mastercard-EUR,,0,0,0,68184.53,68184.53,68184.53,40294413.509999976,40294413.509999976,ACH,EUR
2025-01-16,Settlement from ClientLine,Processor Payout Batch,SET-20250114-ClientLine-Mastercard-CAD,,0,0,0,23235.07,23235.07,23235.07,40317648.579999976,40317648.579999976,ACH,CAD
2025-01-16,Settlement from ClientLine,Processor Payout Batch,SET-20250114-ClientLine-Mastercard-AUD,,0,0,0,9398.58,9398.58,9398.58,40327047.159999974,40327047.159999974,ACH,AUD
2025-01-16,Settlement from Amex,Processor Payout Batch,SET-20250114-Amex-Amex-USD,,0,0,0,206518.56,206518.56,206518.56,40533565.71999998,40533565.71999998,ACH,USD
2025-01-16,Settlement from ClientLine,Processor Payout Batch,SET-20250114-ClientLine-Visa-GBP,,0,0,0,38841.26,38841.26,38841.26,40572406.979999974,40572406.979999974,ACH,GBP
2025-01-16,Settlement from Amex,Processor Payout Batch,SET-20250112-Amex-Amex-CAD,,0,0,0,29646.42,29646.42,29646.42,40602053.399999976,40602053.399999976,ACH,CAD
2025-01-16,Settlement from GoCardless,Processor Payout Batch,SET-20250114-GoCardless-N/A-GBP,,0,0,0,95639.07,95639.07,95639.07,40697692.46999998,40697692.46999998,ACH,GBP
2025-01-16,Settlement from ClientLine,Processor Payout Batch,SET-20250112-ClientLine-Visa-EUR,,0,0,0,52943.37,52943.37,52943.37,40750635.839999974,40750635.839999974,ACH,EUR
2025-01-16,Settlement from Amex,Processor Payout Batch,SET-20250112-Amex-Amex-GBP,,0,0,0,25736.15,25736.15,25736.15,40776371.98999997,40776371.98999997,ACH,GBP
2025-01-16,Settlement from Amex,Processor Payout Batch,SET-20250112-Amex-Amex-USD,,0,0,0,167679.4,167679.4,167679.4,40944051.38999997,40944051.38999997,ACH,USD
2025-01-16,Settlement from ClientLine,Processor Payout Batch,SET-20250112-ClientLine-Mastercard-AUD,,0,0,0,35509.43,35509.43,35509.43,40979560.81999997,40979560.81999997,ACH,AUD
2025-01-16,Settlement from ClientLine,Processor Payout Batch,SET-20250112-ClientLine-Mastercard-CAD,,0,0,0,18360.24,18360.24,18360.24,40997921.05999997,40997921.05999997,ACH,CAD
2025-01-16,Settlement from ClientLine,Processor Payout Batch,SET-20250112-ClientLine-Mastercard-EUR,,0,0,0,70847.24,70847.24,70847.24,41068768.299999975,41068768.299999975,ACH,EUR
2025-01-16,Settlement from ClientLine,Processor Payout Batch,SET-20250112-ClientLine-Mastercard-GBP,,0,0,0,42836.27,42836.27,42836.27,41111604.56999998,41111604.56999998,ACH,GBP
2025-01-16,Settlement from Amex,Processor Payout Batch,SET-20250112-Amex-Amex-EUR,,0,0,0,53920.22,53920.22,53920.22,41165524.78999998,41165524.78999998,ACH,EUR
2025-01-16,Settlement from ClientLine,Processor Payout Batch,SET-20250112-ClientLine-Mastercard-USD,,0,0,0,223979.89,223979.89,223979.89,41389504.67999998,41389504.67999998,ACH,USD
2025-01-16,Settlement from ClientLine,Processor Payout Batch,SET-20250112-ClientLine-Visa-AUD,,0,0,0,47311.25,47311.25,47311.25,41436815.92999998,41436815.92999998,ACH,AUD
2025-01-16,Settlement from ClientLine,Processor Payout Batch,SET-20250112-ClientLine-Visa-CAD,,0,0,0,35450.55,35450.55,35450.55,41472266.479999974,41472266.479999974,ACH,CAD
2025-01-16,Settlement from ClientLine,Processor Payout Batch,SET-20250112-ClientLine-Visa-GBP,,0,0,0,20211.23,20211.23,20211.23,41492477.70999997,41492477.70999997,ACH,GBP
2025-01-16,Settlement from Amex,Processor Payout Batch,SET-20250114-Amex-Amex-AUD,,0,0,0,14729.78,14729.78,14729.78,41507207.48999997,41507207.48999997,ACH,AUD
2025-01-16,Settlement from GoCardless,Processor Payout Batch,SET-20250112-GoCardless-N/A-AUD,,0,0,0,110972.37,110972.37,110972.37,41618179.85999997,41618179.85999997,ACH,AUD
2025-01-16,Settlement from GoCardless,Processor Payout Batch,SET-20250112-GoCardless-N/A-CAD,,0,0,0,93199.38,93199.38,93199.38,41711379.23999997,41711379.23999997,ACH,CAD
2025-01-16,Settlement from GoCardless,Processor Payout Batch,SET-20250112-GoCardless-N/A-EUR,,0,0,0,166025.12,166025.12,166025.12,41877404.35999997,41877404.35999997,ACH,EUR
2025-01-16,Settlement from GoCardless,Processor Payout Batch,SET-20250112-GoCardless-N/A-GBP,,0,0,0,117409.87,117409.87,117409.87,41994814.22999997,41994814.22999997,ACH,GBP
2025-01-16,Settlement from GoCardless,Processor Payout Batch,SET-20250112-GoCardless-N/A-USD,,0,0,0,597267.9,597267.9,597267.9,42592082.129999965,42592082.129999965,ACH,USD
2025-01-16,Settlement from PayPal,Processor Payout Batch,SET-20250112-PayPal-N/A-AUD,,0,0,0,60696.37,60696.37,60696.37,42652778.49999996,42652778.49999996,ACH,AUD
2025-01-16,Settlement from PayPal,Processor Payout Batch,SET-20250112-PayPal-N/A-CAD,,0,0,0,63956.32,63956.32,63956.32,42716734.81999996,42716734.81999996,ACH,CAD
2025-01-16,Settlement from PayPal,Processor Payout Batch,SET-20250112-PayPal-N/A-EUR,,0,0,0,144898.49,144898.49,144898.49,42861633.309999965,42861633.309999965,ACH,EUR
2025-01-16,Settlement from PayPal,Processor Payout Batch,SET-20250112-PayPal-N/A-GBP,,0,0,0,100151.47,100151.47,100151.47,42961784.779999964,42961784.779999964,ACH,GBP
2025-01-16,Settlement from PayPal,Processor Payout Batch,SET-20250112-PayPal-N/A-USD,,0,0,0,695829.1,695829.1,695829.1,43657613.879999965,43657613.879999965,ACH,USD
2025-01-16,Settlement from ClientLine,Processor Payout Batch,SET-20250112-ClientLine-Visa-USD,,0,0,0,184633.33,184633.33,184633.33,43842247.20999996,43842247.20999996,ACH,USD
2025-01-17,Settlement from GoCardless,Processor Payout Batch,SET-20250115-GoCardless-N/A-EUR,,0,0,0,180670.11,180670.11,180670.11,44022917.31999996,44022917.31999996,ACH,EUR
2025-01-17,Settlement from GoCardless,Processor Payout Batch,SET-20250115-GoCardless-N/A-AUD,,0,0,0,102346.46,102346.46,102346.46,44125263.779999964,44125263.779999964,ACH,AUD
2025-01-17,Settlement from GoCardless,Processor Payout Batch,SET-20250115-GoCardless-N/A-CAD,,0,0,0,89504.33,89504.33,89504.33,44214768.10999996,44214768.10999996,ACH,CAD
2025-01-17,Settlement from GoCardless,Processor Payout Batch,SET-20250115-GoCardless-N/A-GBP,,0,0,0,74140.35,74140.35,74140.35,44288908.45999996,44288908.45999996,ACH,GBP
2025-01-17,Settlement from PayPal,Processor Payout Batch,SET-20250115-PayPal-N/A-USD,,0,0,0,689824.43,689824.43,689824.43,44978732.88999996,44978732.88999996,ACH,USD
2025-01-17,Settlement from PayPal,Processor Payout Batch,SET-20250115-PayPal-N/A-AUD,,0,0,0,67034.44,67034.44,67034.44,45045767.32999996,45045767.32999996,ACH,AUD
2025-01-17,Settlement from PayPal,Processor Payout Batch,SET-20250115-PayPal-N/A-CAD,,0,0,0,90326.72,90326.72,90326.72,45136094.04999996,45136094.04999996,ACH,CAD
2025-01-17,Settlement from PayPal,Processor Payout Batch,SET-20250115-PayPal-N/A-EUR,,0,0,0,160814.03,160814.03,160814.03,45296908.07999996,45296908.07999996,ACH,EUR
2025-01-17,Settlement from PayPal,Processor Payout Batch,SET-20250115-PayPal-N/A-GBP,,0,0,0,130052.93,130052.93,130052.93,45426961.00999996,45426961.00999996,ACH,GBP
2025-01-17,Settlement from ClientLine,Processor Payout Batch,SET-20250115-ClientLine-Visa-GBP,,0,0,0,18358.32,18358.32,18358.32,45445319.32999996,45445319.32999996,ACH,GBP
2025-01-17,Settlement from GoCardless,Processor Payout Batch,SET-20250115-GoCardless-N/A-USD,,0,0,0,701886.7,701886.7,701886.7,46147206.029999964,46147206.029999964,ACH,USD
2025-01-17,Settlement from ClientLine,Processor Payout Batch,SET-20250115-ClientLine-Visa-EUR,,0,0,0,46536.82,46536.82,46536.82,46193742.849999964,46193742.849999964,ACH,EUR
2025-01-17,Settlement from ClientLine,Processor Payout Batch,SET-20250115-ClientLine-Visa-USD,,0,0,0,161914.71,161914.71,161914.71,46355657.559999965,46355657.559999965,ACH,USD
2025-01-17,Settlement from ClientLine,Processor Payout Batch,SET-20250115-ClientLine-Visa-AUD,,0,0,0,19028.93,19028.93,19028.93,46374686.489999965,46374686.489999965,ACH,AUD
2025-01-17,Settlement from ClientLine,Processor Payout Batch,SET-20250115-ClientLine-Mastercard-USD,,0,0,0,233424.86,233424.86,233424.86,46608111.349999964,46608111.349999964,ACH,USD
2025-01-17,Settlement from ClientLine,Processor Payout Batch,SET-20250115-ClientLine-Mastercard-GBP,,0,0,0,43672.71,43672.71,43672.71,46651784.059999965,46651784.059999965,ACH,GBP
2025-01-17,Settlement from ClientLine,Processor Payout Batch,SET-20250115-ClientLine-Mastercard-EUR,,0,0,0,51011.57,51011.57,51011.57,46702795.629999965,46702795.629999965,ACH,EUR
2025-01-17,Settlement from ClientLine,Processor Payout Batch,SET-20250115-ClientLine-Mastercard-CAD,,0,0,0,38330.83,38330.83,38330.83,46741126.45999996,46741126.45999996,ACH,CAD
2025-01-17,Settlement from ClientLine,Processor Payout Batch,SET-20250115-ClientLine-Mastercard-AUD,,0,0,0,51580.38,51580.38,51580.38,46792706.83999997,46792706.83999997,ACH,AUD
2025-01-17,Settlement from Amex,Processor Payout Batch,SET-20250115-Amex-Amex-USD,,0,0,0,219711.25,219711.25,219711.25,47012418.08999997,47012418.08999997,ACH,USD
2025-01-17,Settlement from Amex,Processor Payout Batch,SET-20250115-Amex-Amex-GBP,,0,0,0,48596.9,48596.9,48596.9,47061014.989999965,47061014.989999965,ACH,GBP
2025-01-17,Settlement from Amex,Processor Payout Batch,SET-20250115-Amex-Amex-EUR,,0,0,0,44684.41,44684.41,44684.41,47105699.39999996,47105699.39999996,ACH,EUR
2025-01-17,Settlement from Amex,Processor Payout Batch,SET-20250115-Amex-Amex-CAD,,0,0,0,18752.3,18752.3,18752.3,47124451.69999996,47124451.69999996,ACH,CAD
2025-01-17,Settlement from Amex,Processor Payout Batch,SET-20250115-Amex-Amex-AUD,,0,0,0,25365.41,25365.41,25365.41,47149817.109999955,47149817.109999955,ACH,AUD
2025-01-17,Settlement from ClientLine,Processor Payout Batch,SET-20250115-ClientLine-Visa-CAD,,0,0,0,22410.49,22410.49,22410.49,47172227.59999996,47172227.59999996,ACH,CAD
2025-01-20,Settlement from GoCardless,Processor Payout Batch,SET-20250116-GoCardless-N/A-AUD,,0,0,0,85368.87,85368.87,85368.87,47257596.469999954,47257596.469999954,ACH,AUD
2025-01-20,Settlement from GoCardless,Processor Payout Batch,SET-20250116-GoCardless-N/A-CAD,,0,0,0,93238.63,93238.63,93238.63,47350835.09999996,47350835.09999996,ACH,CAD
2025-01-20,Settlement from GoCardless,Processor Payout Batch,SET-20250116-GoCardless-N/A-EUR,,0,0,0,169967.58,169967.58,169967.58,47520802.679999955,47520802.679999955,ACH,EUR
2025-01-20,Settlement from GoCardless,Processor Payout Batch,SET-20250116-GoCardless-N/A-GBP,,0,0,0,85839.58,85839.58,85839.58,47606642.25999995,47606642.25999995,ACH,GBP
2025-01-20,Settlement from PayPal,Processor Payout Batch,SET-20250116-PayPal-N/A-USD,,0,0,0,567439.97,567439.97,567439.97,48174082.22999995,48174082.22999995,ACH,USD
2025-01-20,Settlement from PayPal,Processor Payout Batch,SET-20250116-PayPal-N/A-AUD,,0,0,0,91330.12,91330.12,91330.12,48265412.34999995,48265412.34999995,ACH,AUD
2025-01-20,Settlement from PayPal,Processor Payout Batch,SET-20250116-PayPal-N/A-CAD,,0,0,0,104269.1,104269.1,104269.1,48369681.44999995,48369681.44999995,ACH,CAD
2025-01-20,Settlement from PayPal,Processor Payout Batch,SET-20250116-PayPal-N/A-EUR,,0,0,0,130968.61,130968.61,130968.61,48500650.05999995,48500650.05999995,ACH,EUR
2025-01-20,Settlement from PayPal,Processor Payout Batch,SET-20250116-PayPal-N/A-GBP,,0,0,0,97148.05,97148.05,97148.05,48597798.10999995,48597798.10999995,ACH,GBP
2025-01-20,Settlement from ClientLine,Processor Payout Batch,SET-20250116-ClientLine-Visa-USD,,0,0,0,201589.61,201589.61,201589.61,48799387.71999995,48799387.71999995,ACH,USD
2025-01-20,Settlement from GoCardless,Processor Payout Batch,SET-20250116-GoCardless-N/A-USD,,0,0,0,589487.16,589487.16,589487.16,49388874.87999994,49388874.87999994,ACH,USD
2025-01-20,Settlement from ClientLine,Processor Payout Batch,SET-20250116-ClientLine-Visa-GBP,,0,0,0,32023.32,32023.32,32023.32,49420898.19999994,49420898.19999994,ACH,GBP
2025-01-20,Settlement from ClientLine,Processor Payout Batch,SET-20250116-ClientLine-Mastercard-GBP,,0,0,0,32174.29,32174.29,32174.29,49453072.48999994,49453072.48999994,ACH,GBP
2025-01-20,Settlement from ClientLine,Processor Payout Batch,SET-20250116-ClientLine-Visa-CAD,,0,0,0,19300.55,19300.55,19300.55,49472373.03999994,49472373.03999994,ACH,CAD
2025-01-20,Settlement from ClientLine,Processor Payout Batch,SET-20250116-ClientLine-Visa-AUD,,0,0,0,33594.13,33594.13,33594.13,49505967.16999994,49505967.16999994,ACH,AUD
2025-01-20,Settlement from ClientLine,Processor Payout Batch,SET-20250116-ClientLine-Mastercard-USD,,0,0,0,181880.82,181880.82,181880.82,49687847.98999994,49687847.98999994,ACH,USD
2025-01-20,Settlement from ClientLine,Processor Payout Batch,SET-20250116-ClientLine-Mastercard-EUR,,0,0,0,40829.61,40829.61,40829.61,49728677.59999994,49728677.59999994,ACH,EUR
2025-01-20,Settlement from ClientLine,Processor Payout Batch,SET-20250116-ClientLine-Mastercard-CAD,,0,0,0,24454.38,24454.38,24454.38,49753131.979999945,49753131.979999945,ACH,CAD
2025-01-20,Settlement from ClientLine,Processor Payout Batch,SET-20250116-ClientLine-Mastercard-AUD,,0,0,0,27831.89,27831.89,27831.89,49780963.869999945,49780963.869999945,ACH,AUD
2025-01-20,Settlement from Amex,Processor Payout Batch,SET-20250116-Amex-Amex-USD,,0,0,0,137377.5,137377.5,137377.5,49918341.369999945,49918341.369999945,ACH,USD
2025-01-20,Settlement from Amex,Processor Payout Batch,SET-20250116-Amex-Amex-GBP,,0,0,0,21698.81,21698.81,21698.81,49940040.17999995,49940040.17999995,ACH,GBP
2025-01-20,Settlement from Amex,Processor Payout Batch,SET-20250116-Amex-Amex-EUR,,0,0,0,47222.44,47222.44,47222.44,49987262.619999945,49987262.619999945,ACH,EUR
2025-01-20,Settlement from Amex,Processor Payout Batch,SET-20250116-Amex-Amex-CAD,,0,0,0,19425.83,19425.83,19425.83,50006688.44999994,50006688.44999994,ACH,CAD
2025-01-20,Settlement from Amex,Processor Payout Batch,SET-20250116-Amex-Amex-AUD,,0,0,0,18110.8,18110.8,18110.8,50024799.24999994,50024799.24999994,ACH,AUD
2025-01-20,Settlement from ClientLine,Processor Payout Batch,SET-20250116-ClientLine-Visa-EUR,,0,0,0,35106.28,35106.28,35106.28,50059905.52999994,50059905.52999994,ACH,EUR
2025-01-21,Settlement from GoCardless,Processor Payout Batch,SET-20250117-GoCardless-N/A-AUD,,0,0,0,77736.32,77736.32,77736.32,50137641.84999994,50137641.84999994,ACH,AUD
2025-01-21,Settlement from GoCardless,Processor Payout Batch,SET-20250117-GoCardless-N/A-CAD,,0,0,0,69178.48,69178.48,69178.48,50206820.32999994,50206820.32999994,ACH,CAD
2025-01-21,Settlement from GoCardless,Processor Payout Batch,SET-20250117-GoCardless-N/A-EUR,,0,0,0,185303.14,185303.14,185303.14,50392123.46999994,50392123.46999994,ACH,EUR
2025-01-21,Settlement from GoCardless,Processor Payout Batch,SET-20250117-GoCardless-N/A-GBP,,0,0,0,72836.58,72836.58,72836.58,50464960.04999994,50464960.04999994,ACH,GBP
2025-01-21,Settlement from PayPal,Processor Payout Batch,SET-20250117-PayPal-N/A-USD,,0,0,0,655827.66,655827.66,655827.66,51120787.709999934,51120787.709999934,ACH,USD
2025-01-21,Settlement from PayPal,Processor Payout Batch,SET-20250117-PayPal-N/A-AUD,,0,0,0,85774.22,85774.22,85774.22,51206561.92999993,51206561.92999993,ACH,AUD
2025-01-21,Settlement from PayPal,Processor Payout Batch,SET-20250117-PayPal-N/A-CAD,,0,0,0,90109.29,90109.29,90109.29,51296671.21999993,51296671.21999993,ACH,CAD
2025-01-21,Settlement from PayPal,Processor Payout Batch,SET-20250117-PayPal-N/A-EUR,,0,0,0,155848.77,155848.77,155848.77,51452519.989999935,51452519.989999935,ACH,EUR
2025-01-21,Settlement from PayPal,Processor Payout Batch,SET-20250117-PayPal-N/A-GBP,,0,0,0,109254.56,109254.56,109254.56,51561774.54999994,51561774.54999994,ACH,GBP
2025-01-21,Settlement from ClientLine,Processor Payout Batch,SET-20250117-ClientLine-Visa-USD,,0,0,0,218288.86,218288.86,218288.86,51780063.40999994,51780063.40999994,ACH,USD
2025-01-21,Settlement from GoCardless,Processor Payout Batch,SET-20250117-GoCardless-N/A-USD,,0,0,0,607552.84,607552.84,607552.84,52387616.24999994,52387616.24999994,ACH,USD
2025-01-21,Settlement from ClientLine,Processor Payout Batch,SET-20250117-ClientLine-Visa-GBP,,0,0,0,27967.43,27967.43,27967.43,52415583.67999994,52415583.67999994,ACH,GBP
2025-01-21,Settlement from ClientLine,Processor Payout Batch,SET-20250117-ClientLine-Mastercard-CAD,,0,0,0,29931.93,29931.93,29931.93,52445515.60999994,52445515.60999994,ACH,CAD
2025-01-21,Settlement from ClientLine,Processor Payout Batch,SET-20250117-ClientLine-Visa-CAD,,0,0,0,10128.1,10128.1,10128.1,52455643.70999994,52455643.70999994,ACH,CAD
2025-01-21,Settlement from ClientLine,Processor Payout Batch,SET-20250117-ClientLine-Visa-AUD,,0,0,0,19052.66,19052.66,19052.66,52474696.36999994,52474696.36999994,ACH,AUD
2025-01-21,Settlement from ClientLine,Processor Payout Batch,SET-20250117-ClientLine-Mastercard-USD,,0,0,0,213529.48,213529.48,213529.48,52688225.849999934,52688225.849999934,ACH,USD
2025-01-21,Settlement from ClientLine,Processor Payout Batch,SET-20250117-ClientLine-Mastercard-GBP,,0,0,0,45789.39,45789.39,45789.39,52734015.239999935,52734015.239999935,ACH,GBP
2025-01-21,Settlement from ClientLine,Processor Payout Batch,SET-20250117-ClientLine-Mastercard-EUR,,0,0,0,49546.37,49546.37,49546.37,52783561.60999993,52783561.60999993,ACH,EUR
2025-01-21,Settlement from ClientLine,Processor Payout Batch,SET-20250117-ClientLine-Mastercard-AUD,,0,0,0,30793.89,30793.89,30793.89,52814355.49999993,52814355.49999993,ACH,AUD
2025-01-21,Settlement from Amex,Processor Payout Batch,SET-20250117-Amex-Amex-USD,,0,0,0,198493.75,198493.75,198493.75,53012849.24999993,53012849.24999993,ACH,USD
2025-01-21,Settlement from Amex,Processor Payout Batch,SET-20250117-Amex-Amex-GBP,,0,0,0,21441.49,21441.49,21441.49,53034290.739999935,53034290.739999935,ACH,GBP
2025-01-21,Settlement from Amex,Processor Payout Batch,SET-20250117-Amex-Amex-EUR,,0,0,0,64464.65,64464.65,64464.65,53098755.38999993,53098755.38999993,ACH,EUR
2025-01-21,Settlement from Amex,Processor Payout Batch,SET-20250117-Amex-Amex-CAD,,0,0,0,26783.39,26783.39,26783.39,53125538.779999934,53125538.779999934,ACH,CAD
2025-01-21,Settlement from Amex,Processor Payout Batch,SET-20250117-Amex-Amex-AUD,,0,0,0,24614.83,24614.83,24614.83,53150153.60999993,53150153.60999993,ACH,AUD
2025-01-21,Settlement from ClientLine,Processor Payout Batch,SET-20250117-ClientLine-Visa-EUR,,0,0,0,56255.41,56255.41,56255.41,53206409.01999993,53206409.01999993,ACH,EUR
2025-01-22,Settlement from ClientLine,Processor Payout Batch,SET-20250120-ClientLine-Mastercard-GBP,,0,0,0,7265.99,7265.99,7265.99,53213675.00999993,53213675.00999993,ACH,GBP
2025-01-22,Settlement from ClientLine,Processor Payout Batch,SET-20250120-ClientLine-Mastercard-EUR,,0,0,0,40688.46,40688.46,40688.46,53254363.46999993,53254363.46999993,ACH,EUR
2025-01-22,Settlement from ClientLine,Processor Payout Batch,SET-20250120-ClientLine-Mastercard-CAD,,0,0,0,18853.83,18853.83,18853.83,53273217.29999993,53273217.29999993,ACH,CAD
2025-01-22,Settlement from ClientLine,Processor Payout Batch,SET-20250120-ClientLine-Mastercard-AUD,,0,0,0,19137.66,19137.66,19137.66,53292354.95999993,53292354.95999993,ACH,AUD
2025-01-22,Settlement from Amex,Processor Payout Batch,SET-20250120-Amex-Amex-AUD,,0,0,0,23415.94,23415.94,23415.94,53315770.899999924,53315770.899999924,ACH,AUD
2025-01-22,Settlement from Amex,Processor Payout Batch,SET-20250120-Amex-Amex-GBP,,0,0,0,59489.69,59489.69,59489.69,53375260.58999992,53375260.58999992,ACH,GBP
2025-01-22,Settlement from Amex,Processor Payout Batch,SET-20250120-Amex-Amex-EUR,,0,0,0,41863.47,41863.47,41863.47,53417124.05999992,53417124.05999992,ACH,EUR
2025-01-22,Settlement from Amex,Processor Payout Batch,SET-20250120-Amex-Amex-CAD,,0,0,0,20143.8,20143.8,20143.8,53437267.85999992,53437267.85999992,ACH,CAD
2025-01-22,Settlement from ClientLine,Processor Payout Batch,SET-20250120-ClientLine-Mastercard-USD,,0,0,0,228484.85,228484.85,228484.85,53665752.70999992,53665752.70999992,ACH,USD
2025-01-22,Settlement from Amex,Processor Payout Batch,SET-20250120-Amex-Amex-USD,,0,0,0,228250.97,228250.97,228250.97,53894003.67999992,53894003.67999992,ACH,USD
2025-01-22,Settlement from ClientLine,Processor Payout Batch,SET-20250120-ClientLine-Visa-AUD,,0,0,0,32922.8,32922.8,32922.8,53926926.479999915,53926926.479999915,ACH,AUD
2025-01-22,Settlement from GoCardless,Processor Payout Batch,SET-20250120-GoCardless-N/A-CAD,,0,0,0,64841.25,64841.25,64841.25,53991767.729999915,53991767.729999915,ACH,CAD
2025-01-22,Settlement from ClientLine,Processor Payout Batch,SET-20250120-ClientLine-Visa-EUR,,0,0,0,60122.81,60122.81,60122.81,54051890.53999992,54051890.53999992,ACH,EUR
2025-01-22,Settlement from ClientLine,Processor Payout Batch,SET-20250120-ClientLine-Visa-GBP,,0,0,0,56447.83,56447.83,56447.83,54108338.369999915,54108338.369999915,ACH,GBP
2025-01-22,Settlement from ClientLine,Processor Payout Batch,SET-20250120-ClientLine-Visa-USD,,0,0,0,162461.14,162461.14,162461.14,54270799.509999916,54270799.509999916,ACH,USD
2025-01-22,Settlement from GoCardless,Processor Payout Batch,SET-20250120-GoCardless-N/A-AUD,,0,0,0,89881.86,89881.86,89881.86,54360681.369999915,54360681.369999915,ACH,AUD
2025-01-22,Settlement from GoCardless,Processor Payout Batch,SET-20250120-GoCardless-N/A-EUR,,0,0,0,109717.35,109717.35,109717.35,54470398.71999992,54470398.71999992,ACH,EUR
2025-01-22,Settlement from GoCardless,Processor Payout Batch,SET-20250120-GoCardless-N/A-GBP,,0,0,0,109652.5,109652.5,109652.5,54580051.21999992,54580051.21999992,ACH,GBP
2025-01-22,Settlement from GoCardless,Processor Payout Batch,SET-20250120-GoCardless-N/A-USD,,0,0,0,596482.64,596482.64,596482.64,55176533.85999992,55176533.85999992,ACH,USD
2025-01-22,Settlement from PayPal,Processor Payout Batch,SET-20250120-PayPal-N/A-AUD,,0,0,0,109691.42,109691.42,109691.42,55286225.27999992,55286225.27999992,ACH,AUD
2025-01-22,Settlement from PayPal,Processor Payout Batch,SET-20250120-PayPal-N/A-CAD,,0,0,0,59311.83,59311.83,59311.83,55345537.10999992,55345537.10999992,ACH,CAD
2025-01-22,Settlement from PayPal,Processor Payout Batch,SET-20250120-PayPal-N/A-EUR,,0,0,0,143190.82,143190.82,143190.82,55488727.92999992,55488727.92999992,ACH,EUR
2025-01-22,Settlement from ClientLine,Processor Payout Batch,SET-20250120-ClientLine-Visa-CAD,,0,0,0,40571.22,40571.22,40571.22,55529299.14999992,55529299.14999992,ACH,CAD
2025-01-22,Settlement from PayPal,Processor Payout Batch,SET-20250120-PayPal-N/A-GBP,,0,0,0,139203.84,139203.84,139203.84,55668502.98999992,55668502.98999992,ACH,GBP
2025-01-22,Settlement from PayPal,Processor Payout Batch,SET-20250120-PayPal-N/A-USD,,0,0,0,749550.42,749550.42,749550.42,56418053.40999992,56418053.40999992,ACH,USD
2025-01-22,Settlement from PayPal,Processor Payout Batch,SET-20250118-PayPal-N/A-EUR,,0,0,0,143130.8,143130.8,143130.8,56561184.20999992,56561184.20999992,ACH,EUR
2025-01-22,Settlement from PayPal,Processor Payout Batch,SET-20250118-PayPal-N/A-AUD,,0,0,0,62983.46,62983.46,62983.46,56624167.66999992,56624167.66999992,ACH,AUD
2025-01-22,Settlement from GoCardless,Processor Payout Batch,SET-20250118-GoCardless-N/A-USD,,0,0,0,643250.39,643250.39,643250.39,57267418.05999992,57267418.05999992,ACH,USD
2025-01-22,Settlement from GoCardless,Processor Payout Batch,SET-20250118-GoCardless-N/A-GBP,,0,0,0,122706.36,122706.36,122706.36,57390124.41999992,57390124.41999992,ACH,GBP
2025-01-22,Settlement from GoCardless,Processor Payout Batch,SET-20250118-GoCardless-N/A-EUR,,0,0,0,140879.05,140879.05,140879.05,57531003.46999992,57531003.46999992,ACH,EUR
2025-01-22,Settlement from GoCardless,Processor Payout Batch,SET-20250118-GoCardless-N/A-CAD,,0,0,0,54552.11,54552.11,54552.11,57585555.579999916,57585555.579999916,ACH,CAD
2025-01-22,Settlement from GoCardless,Processor Payout Batch,SET-20250118-GoCardless-N/A-AUD,,0,0,0,82570.3,82570.3,82570.3,57668125.87999991,57668125.87999991,ACH,AUD
2025-01-22,Settlement from ClientLine,Processor Payout Batch,SET-20250118-ClientLine-Visa-USD,,0,0,0,209553.91,209553.91,209553.91,57877679.78999991,57877679.78999991,ACH,USD
2025-01-22,Settlement from ClientLine,Processor Payout Batch,SET-20250118-ClientLine-Visa-GBP,,0,0,0,19813.46,19813.46,19813.46,57897493.24999991,57897493.24999991,ACH,GBP
2025-01-22,Settlement from ClientLine,Processor Payout Batch,SET-20250118-ClientLine-Visa-EUR,,0,0,0,62434.25,62434.25,62434.25,57959927.49999991,57959927.49999991,ACH,EUR
2025-01-22,Settlement from ClientLine,Processor Payout Batch,SET-20250118-ClientLine-Visa-CAD,,0,0,0,25353.63,25353.63,25353.63,57985281.12999991,57985281.12999991,ACH,CAD
2025-01-22,Settlement from ClientLine,Processor Payout Batch,SET-20250118-ClientLine-Visa-AUD,,0,0,0,13185.09,13185.09,13185.09,57998466.21999992,57998466.21999992,ACH,AUD
2025-01-22,Settlement from ClientLine,Processor Payout Batch,SET-20250118-ClientLine-Mastercard-USD,,0,0,0,173113.69,173113.69,173113.69,58171579.909999914,58171579.909999914,ACH,USD
2025-01-22,Settlement from ClientLine,Processor Payout Batch,SET-20250118-ClientLine-Mastercard-GBP,,0,0,0,43662.21,43662.21,43662.21,58215242.119999915,58215242.119999915,ACH,GBP
2025-01-22,Settlement from ClientLine,Processor Payout Batch,SET-20250118-ClientLine-Mastercard-EUR,,0,0,0,67319.25,67319.25,67319.25,58282561.369999915,58282561.369999915,ACH,EUR
2025-01-22,Settlement from ClientLine,Processor Payout Batch,SET-20250118-ClientLine-Mastercard-CAD,,0,0,0,16437.19,16437.19,16437.19,58298998.55999991,58298998.55999991,ACH,CAD
2025-01-22,Settlement from ClientLine,Processor Payout Batch,SET-20250118-ClientLine-Mastercard-AUD,,0,0,0,29415.18,29415.18,29415.18,58328413.73999991,58328413.73999991,ACH,AUD
2025-01-22,Settlement from Amex,Processor Payout Batch,SET-20250118-Amex-Amex-USD,,0,0,0,229289.06,229289.06,229289.06,58557702.799999915,58557702.799999915,ACH,USD
2025-01-22,Settlement from PayPal,Processor Payout Batch,SET-20250118-PayPal-N/A-GBP,,0,0,0,105392.52,105392.52,105392.52,58663095.31999992,58663095.31999992,ACH,GBP
2025-01-22,Settlement from Amex,Processor Payout Batch,SET-20250118-Amex-Amex-GBP,,0,0,0,21242.63,21242.63,21242.63,58684337.94999992,58684337.94999992,ACH,GBP
2025-01-22,Settlement from Amex,Processor Payout Batch,SET-20250118-Amex-Amex-EUR,,0,0,0,46751.64,46751.64,46751.64,58731089.58999992,58731089.58999992,ACH,EUR
2025-01-22,Settlement from Amex,Processor Payout Batch,SET-20250118-Amex-Amex-CAD,,0,0,0,14561.99,14561.99,14561.99,58745651.57999992,58745651.57999992,ACH,CAD
2025-01-22,Settlement from Amex,Processor Payout Batch,SET-20250118-Amex-Amex-AUD,,0,0,0,16976.24,16976.24,16976.24,58762627.819999926,58762627.819999926,ACH,AUD
2025-01-22,Settlement from PayPal,Processor Payout Batch,SET-20250118-PayPal-N/A-USD,,0,0,0,583356.82,583356.82,583356.82,59345984.639999926,59345984.639999926,ACH,USD
2025-01-22,Settlement from PayPal,Processor Payout Batch,SET-20250118-PayPal-N/A-CAD,,0,0,0,64396.43,64396.43,64396.43,59410381.069999926,59410381.069999926,ACH,CAD
2025-01-23,Settlement from PayPal,Processor Payout Batch,SET-20250121-PayPal-N/A-USD,,0,0,0,684456.26,684456.26,684456.26,60094837.32999992,60094837.32999992,ACH,USD
2025-01-23,Settlement from PayPal,Processor Payout Batch,SET-20250121-PayPal-N/A-GBP,,0,0,0,113981.03,113981.03,113981.03,60208818.359999925,60208818.359999925,ACH,GBP
2025-01-23,Settlement from Amex,Processor Payout Batch,SET-20250121-Amex-Amex-CAD,,0,0,0,8736.6,8736.6,8736.6,60217554.95999993,60217554.95999993,ACH,CAD
2025-01-23,Settlement from PayPal,Processor Payout Batch,SET-20250121-PayPal-N/A-EUR,,0,0,0,170075.76,170075.76,170075.76,60387630.719999924,60387630.719999924,ACH,EUR
2025-01-23,Settlement from PayPal,Processor Payout Batch,SET-20250121-PayPal-N/A-CAD,,0,0,0,66893.45,66893.45,66893.45,60454524.16999993,60454524.16999993,ACH,CAD
2025-01-23,Settlement from PayPal,Processor Payout Batch,SET-20250121-PayPal-N/A-AUD,,0,0,0,55026.29,55026.29,55026.29,60509550.45999993,60509550.45999993,ACH,AUD
2025-01-23,Settlement from GoCardless,Processor Payout Batch,SET-20250121-GoCardless-N/A-USD,,0,0,0,604922.26,604922.26,604922.26,61114472.719999924,61114472.719999924,ACH,USD
2025-01-23,Settlement from GoCardless,Processor Payout Batch,SET-20250121-GoCardless-N/A-GBP,,0,0,0,90477.85,90477.85,90477.85,61204950.569999926,61204950.569999926,ACH,GBP
2025-01-23,Settlement from GoCardless,Processor Payout Batch,SET-20250121-GoCardless-N/A-CAD,,0,0,0,56545.54,56545.54,56545.54,61261496.109999925,61261496.109999925,ACH,CAD
2025-01-23,Settlement from GoCardless,Processor Payout Batch,SET-20250121-GoCardless-N/A-AUD,,0,0,0,71265.59,71265.59,71265.59,61332761.69999993,61332761.69999993,ACH,AUD
2025-01-23,Settlement from ClientLine,Processor Payout Batch,SET-20250121-ClientLine-Visa-USD,,0,0,0,192203.66,192203.66,192203.66,61524965.359999925,61524965.359999925,ACH,USD
2025-01-23,Settlement from ClientLine,Processor Payout Batch,SET-20250121-ClientLine-Visa-GBP,,0,0,0,29183.57,29183.57,29183.57,61554148.929999925,61554148.929999925,ACH,GBP
2025-01-23,Settlement from Amex,Processor Payout Batch,SET-20250121-Amex-Amex-AUD,,0,0,0,36494.12,36494.12,36494.12,61590643.04999992,61590643.04999992,ACH,AUD
2025-01-23,Settlement from ClientLine,Processor Payout Batch,SET-20250121-ClientLine-Visa-EUR,,0,0,0,65800.71,65800.71,65800.71,61656443.75999992,61656443.75999992,ACH,EUR
2025-01-23,Settlement from ClientLine,Processor Payout Batch,SET-20250121-ClientLine-Visa-AUD,,0,0,0,15486.08,15486.08,15486.08,61671929.83999992,61671929.83999992,ACH,AUD
2025-01-23,Settlement from ClientLine,Processor Payout Batch,SET-20250121-ClientLine-Mastercard-USD,,0,0,0,201851.92,201851.92,201851.92,61873781.75999992,61873781.75999992,ACH,USD
2025-01-23,Settlement from ClientLine,Processor Payout Batch,SET-20250121-ClientLine-Mastercard-GBP,,0,0,0,31942.74,31942.74,31942.74,61905724.499999925,61905724.499999925,ACH,GBP
2025-01-23,Settlement from ClientLine,Processor Payout Batch,SET-20250121-ClientLine-Mastercard-EUR,,0,0,0,50378.06,50378.06,50378.06,61956102.55999993,61956102.55999993,ACH,EUR
2025-01-23,Settlement from ClientLine,Processor Payout Batch,SET-20250121-ClientLine-Mastercard-CAD,,0,0,0,22746.75,22746.75,22746.75,61978849.30999993,61978849.30999993,ACH,CAD
2025-01-23,Settlement from ClientLine,Processor Payout Batch,SET-20250121-ClientLine-Mastercard-AUD,,0,0,0,16949.57,16949.57,16949.57,61995798.87999993,61995798.87999993,ACH,AUD
2025-01-23,Settlement from Amex,Processor Payout Batch,SET-20250121-Amex-Amex-USD,,0,0,0,211184.53,211184.53,211184.53,62206983.40999993,62206983.40999993,ACH,USD
2025-01-23,Settlement from Amex,Processor Payout Batch,SET-20250121-Amex-Amex-GBP,,0,0,0,31598.65,31598.65,31598.65,62238582.05999993,62238582.05999993,ACH,GBP
2025-01-23,Settlement from Amex,Processor Payout Batch,SET-20250121-Amex-Amex-EUR,,0,0,0,46514.58,46514.58,46514.58,62285096.639999926,62285096.639999926,ACH,EUR
2025-01-23,Settlement from ClientLine,Processor Payout Batch,SET-20250121-ClientLine-Visa-CAD,,0,0,0,36975.88,36975.88,36975.88,62322072.51999993,62322072.51999993,ACH,CAD
2025-01-23,Settlement from GoCardless,Processor Payout Batch,SET-20250121-GoCardless-N/A-EUR,,0,0,0,137312.66,137312.66,137312.66,62459385.179999925,62459385.179999925,ACH,EUR
2025-01-23,Settlement from PayPal,Processor Payout Batch,SET-20250119-PayPal-N/A-USD,,0,0,0,554081.62,554081.62,554081.62,63013466.79999992,63013466.79999992,ACH,USD
2025-01-23,Settlement from PayPal,Processor Payout Batch,SET-20250119-PayPal-N/A-EUR,,0,0,0,157568.91,157568.91,157568.91,63171035.70999992,63171035.70999992,ACH,EUR
2025-01-23,Settlement from Amex,Processor Payout Batch,SET-20250119-Amex-Amex-AUD,,0,0,0,15154.63,15154.63,15154.63,63186190.33999992,63186190.33999992,ACH,AUD
2025-01-23,Settlement from Amex,Processor Payout Batch,SET-20250119-Amex-Amex-CAD,,0,0,0,17887.99,17887.99,17887.99,63204078.32999992,63204078.32999992,ACH,CAD
2025-01-23,Settlement from Amex,Processor Payout Batch,SET-20250119-Amex-Amex-EUR,,0,0,0,36100.68,36100.68,36100.68,63240179.00999992,63240179.00999992,ACH,EUR
2025-01-23,Settlement from Amex,Processor Payout Batch,SET-20250119-Amex-Amex-GBP,,0,0,0,18537.06,18537.06,18537.06,63258716.069999926,63258716.069999926,ACH,GBP
2025-01-23,Settlement from Amex,Processor Payout Batch,SET-20250119-Amex-Amex-USD,,0,0,0,226294.78,226294.78,226294.78,63485010.84999993,63485010.84999993,ACH,USD
2025-01-23,Settlement from PayPal,Processor Payout Batch,SET-20250119-PayPal-N/A-GBP,,0,0,0,101573.22,101573.22,101573.22,63586584.069999926,63586584.069999926,ACH,GBP
2025-01-23,Settlement from ClientLine,Processor Payout Batch,SET-20250119-ClientLine-Mastercard-CAD,,0,0,0,18244.57,18244.57,18244.57,63604828.639999926,63604828.639999926,ACH,CAD
2025-01-23,Settlement from ClientLine,Processor Payout Batch,SET-20250119-ClientLine-Mastercard-EUR,,0,0,0,50699.4,50699.4,50699.4,63655528.039999925,63655528.039999925,ACH,EUR
2025-01-23,Settlement from ClientLine,Processor Payout Batch,SET-20250119-ClientLine-Mastercard-GBP,,0,0,0,50695.83,50695.83,50695.83,63706223.86999992,63706223.86999992,ACH,GBP
2025-01-23,Settlement from ClientLine,Processor Payout Batch,SET-20250119-ClientLine-Mastercard-USD,,0,0,0,211689.22,211689.22,211689.22,63917913.08999992,63917913.08999992,ACH,USD
2025-01-23,Settlement from ClientLine,Processor Payout Batch,SET-20250119-ClientLine-Visa-AUD,,0,0,0,22755.75,22755.75,22755.75,63940668.83999992,63940668.83999992,ACH,AUD
2025-01-23,Settlement from ClientLine,Processor Payout Batch,SET-20250119-ClientLine-Mastercard-AUD,,0,0,0,34897.12,34897.12,34897.12,63975565.95999992,63975565.95999992,ACH,AUD
2025-01-23,Settlement from ClientLine,Processor Payout Batch,SET-20250119-ClientLine-Visa-EUR,,0,0,0,24704.97,24704.97,24704.97,64000270.92999992,64000270.92999992,ACH,EUR
2025-01-23,Settlement from ClientLine,Processor Payout Batch,SET-20250119-ClientLine-Visa-GBP,,0,0,0,47091.24,47091.24,47091.24,64047362.16999992,64047362.16999992,ACH,GBP
2025-01-23,Settlement from ClientLine,Processor Payout Batch,SET-20250119-ClientLine-Visa-USD,,0,0,0,248426.65,248426.65,248426.65,64295788.81999992,64295788.81999992,ACH,USD
2025-01-23,Settlement from GoCardless,Processor Payout Batch,SET-20250119-GoCardless-N/A-AUD,,0,0,0,60997.06,60997.06,60997.06,64356785.87999992,64356785.87999992,ACH,AUD
2025-01-23,Settlement from GoCardless,Processor Payout Batch,SET-20250119-GoCardless-N/A-CAD,,0,0,0,85668.03,85668.03,85668.03,64442453.90999992,64442453.90999992,ACH,CAD
2025-01-23,Settlement from GoCardless,Processor Payout Batch,SET-20250119-GoCardless-N/A-EUR,,0,0,0,125068.26,125068.26,125068.26,64567522.16999992,64567522.16999992,ACH,EUR
2025-01-23,Settlement from GoCardless,Processor Payout Batch,SET-20250119-GoCardless-N/A-GBP,,0,0,0,80105.6,80105.6,80105.6,64647627.76999992,64647627.76999992,ACH,GBP
2025-01-23,Settlement from GoCardless,Processor Payout Batch,SET-20250119-GoCardless-N/A-USD,,0,0,0,696299.76,696299.76,696299.76,65343927.52999992,65343927.52999992,ACH,USD
2025-01-23,Settlement from PayPal,Processor Payout Batch,SET-20250119-PayPal-N/A-AUD,,0,0,0,90123.54,90123.54,90123.54,65434051.06999992,65434051.06999992,ACH,AUD
2025-01-23,Settlement from PayPal,Processor Payout Batch,SET-20250119-PayPal-N/A-CAD,,0,0,0,71337.95,71337.95,71337.95,65505389.01999992,65505389.01999992,ACH,CAD
2025-01-23,Settlement from ClientLine,Processor Payout Batch,SET-20250119-ClientLine-Visa-CAD,,0,0,0,13762.89,13762.89,13762.89,65519151.90999992,65519151.90999992,ACH,CAD
2025-01-24,Settlement from ClientLine,Processor Payout Batch,SET-20250122-ClientLine-Visa-USD,,0,0,0,221508.48,221508.48,221508.48,65740660.38999992,65740660.38999992,ACH,USD
2025-01-24,Settlement from GoCardless,Processor Payout Batch,SET-20250122-GoCardless-N/A-AUD,,0,0,0,75578.58,75578.58,75578.58,65816238.96999992,65816238.96999992,ACH,AUD
2025-01-24,Settlement from GoCardless,Processor Payout Batch,SET-20250122-GoCardless-N/A-CAD,,0,0,0,65220.42,65220.42,65220.42,65881459.38999992,65881459.38999992,ACH,CAD
2025-01-24,Settlement from GoCardless,Processor Payout Batch,SET-20250122-GoCardless-N/A-EUR,,0,0,0,139708.87,139708.87,139708.87,66021168.259999916,66021168.259999916,ACH,EUR
2025-01-24,Settlement from GoCardless,Processor Payout Batch,SET-20250122-GoCardless-N/A-USD,,0,0,0,621591.25,621591.25,621591.25,66642759.509999916,66642759.509999916,ACH,USD
2025-01-24,Settlement from PayPal,Processor Payout Batch,SET-20250122-PayPal-N/A-USD,,0,0,0,642903.77,642903.77,642903.77,67285663.27999991,67285663.27999991,ACH,USD
2025-01-24,Settlement from PayPal,Processor Payout Batch,SET-20250122-PayPal-N/A-CAD,,0,0,0,85912.99,85912.99,85912.99,67371576.2699999,67371576.2699999,ACH,CAD
2025-01-24,Settlement from PayPal,Processor Payout Batch,SET-20250122-PayPal-N/A-EUR,,0,0,0,149728.14,149728.14,149728.14,67521304.4099999,67521304.4099999,ACH,EUR
2025-01-24,Settlement from PayPal,Processor Payout Batch,SET-20250122-PayPal-N/A-GBP,,0,0,0,124793.81,124793.81,124793.81,67646098.21999991,67646098.21999991,ACH,GBP
2025-01-24,Settlement from ClientLine,Processor Payout Batch,SET-20250122-ClientLine-Visa-GBP,,0,0,0,49690.73,49690.73,49690.73,67695788.94999991,67695788.94999991,ACH,GBP
2025-01-24,Settlement from PayPal,Processor Payout Batch,SET-20250122-PayPal-N/A-AUD,,0,0,0,74438.23,74438.23,74438.23,67770227.17999992,67770227.17999992,ACH,AUD
2025-01-24,Settlement from ClientLine,Processor Payout Batch,SET-20250122-ClientLine-Visa-EUR,,0,0,0,46992.22,46992.22,46992.22,67817219.39999992,67817219.39999992,ACH,EUR
2025-01-24,Settlement from GoCardless,Processor Payout Batch,SET-20250122-GoCardless-N/A-GBP,,0,0,0,140377.37,140377.37,140377.37,67957596.76999992,67957596.76999992,ACH,GBP
2025-01-24,Settlement from ClientLine,Processor Payout Batch,SET-20250122-ClientLine-Visa-AUD,,0,0,0,36934.47,36934.47,36934.47,67994531.23999992,67994531.23999992,ACH,AUD
2025-01-24,Settlement from Amex,Processor Payout Batch,SET-20250122-Amex-Amex-CAD,,0,0,0,29907.6,29907.6,29907.6,68024438.83999991,68024438.83999991,ACH,CAD
2025-01-24,Settlement from Amex,Processor Payout Batch,SET-20250122-Amex-Amex-EUR,,0,0,0,53040.66,53040.66,53040.66,68077479.49999991,68077479.49999991,ACH,EUR
2025-01-24,Settlement from Amex,Processor Payout Batch,SET-20250122-Amex-Amex-GBP,,0,0,0,37840.68,37840.68,37840.68,68115320.17999992,68115320.17999992,ACH,GBP
2025-01-24,Settlement from Amex,Processor Payout Batch,SET-20250122-Amex-Amex-USD,,0,0,0,223624.93,223624.93,223624.93,68338945.10999992,68338945.10999992,ACH,USD
2025-01-24,Settlement from ClientLine,Processor Payout Batch,SET-20250122-ClientLine-Mastercard-AUD,,0,0,0,31448.67,31448.67,31448.67,68370393.77999993,68370393.77999993,ACH,AUD
2025-01-24,Settlement from Amex,Processor Payout Batch,SET-20250122-Amex-Amex-AUD,,0,0,0,25034.69,25034.69,25034.69,68395428.46999992,68395428.46999992,ACH,AUD
2025-01-24,Settlement from ClientLine,Processor Payout Batch,SET-20250122-ClientLine-Mastercard-CAD,,0,0,0,21820.33,21820.33,21820.33,68417248.79999992,68417248.79999992,ACH,CAD
2025-01-24,Settlement from ClientLine,Processor Payout Batch,SET-20250122-ClientLine-Mastercard-EUR,,0,0,0,47533.42,47533.42,47533.42,68464782.21999992,68464782.21999992,ACH,EUR
2025-01-24,Settlement from ClientLine,Processor Payout Batch,SET-20250122-ClientLine-Mastercard-GBP,,0,0,0,28237.53,28237.53,28237.53,68493019.74999993,68493019.74999993,ACH,GBP
2025-01-24,Settlement from ClientLine,Processor Payout Batch,SET-20250122-ClientLine-Mastercard-USD,,0,0,0,198760.03,198760.03,198760.03,68691779.77999993,68691779.77999993,ACH,USD
2025-01-24,Settlement from ClientLine,Processor Payout Batch,SET-20250122-ClientLine-Visa-CAD,,0,0,0,27399.58,27399.58,27399.58,68719179.35999992,68719179.35999992,ACH,CAD
2025-01-27,Settlement from GoCardless,Processor Payout Batch,SET-20250123-GoCardless-N/A-AUD,,0,0,0,80726.04,80726.04,80726.04,68799905.39999993,68799905.39999993,ACH,AUD
2025-01-27,Settlement from GoCardless,Processor Payout Batch,SET-20250123-GoCardless-N/A-CAD,,0,0,0,69160.37,69160.37,69160.37,68869065.76999994,68869065.76999994,ACH,CAD
2025-01-27,Settlement from GoCardless,Processor Payout Batch,SET-20250123-GoCardless-N/A-EUR,,0,0,0,107635.91,107635.91,107635.91,68976701.67999993,68976701.67999993,ACH,EUR
2025-01-27,Settlement from GoCardless,Processor Payout Batch,SET-20250123-GoCardless-N/A-GBP,,0,0,0,108197.62,108197.62,108197.62,69084899.29999994,69084899.29999994,ACH,GBP
2025-01-27,Settlement from GoCardless,Processor Payout Batch,SET-20250123-GoCardless-N/A-USD,,0,0,0,590913.88,590913.88,590913.88,69675813.17999993,69675813.17999993,ACH,USD
2025-01-27,Settlement from PayPal,Processor Payout Batch,SET-20250123-PayPal-N/A-CAD,,0,0,0,63191.39,63191.39,63191.39,69739004.56999993,69739004.56999993,ACH,CAD
2025-01-27,Settlement from PayPal,Processor Payout Batch,SET-20250123-PayPal-N/A-EUR,,0,0,0,125593.58,125593.58,125593.58,69864598.14999993,69864598.14999993,ACH,EUR
2025-01-27,Settlement from PayPal,Processor Payout Batch,SET-20250123-PayPal-N/A-GBP,,0,0,0,135918.16,135918.16,135918.16,70000516.30999993,70000516.30999993,ACH,GBP
2025-01-27,Settlement from PayPal,Processor Payout Batch,SET-20250123-PayPal-N/A-USD,,0,0,0,597022.09,597022.09,597022.09,70597538.39999993,70597538.39999993,ACH,USD
2025-01-27,Settlement from ClientLine,Processor Payout Batch,SET-20250123-ClientLine-Visa-USD,,0,0,0,239894.5,239894.5,239894.5,70837432.89999993,70837432.89999993,ACH,USD
2025-01-27,Settlement from PayPal,Processor Payout Batch,SET-20250123-PayPal-N/A-AUD,,0,0,0,73930.96,73930.96,73930.96,70911363.85999992,70911363.85999992,ACH,AUD
2025-01-27,Settlement from ClientLine,Processor Payout Batch,SET-20250123-ClientLine-Visa-GBP,,0,0,0,34776.38,34776.38,34776.38,70946140.23999992,70946140.23999992,ACH,GBP
2025-01-27,Settlement from ClientLine,Processor Payout Batch,SET-20250123-ClientLine-Visa-EUR,,0,0,0,44775.72,44775.72,44775.72,70990915.95999992,70990915.95999992,ACH,EUR
2025-01-27,Settlement from ClientLine,Processor Payout Batch,SET-20250123-ClientLine-Visa-CAD,,0,0,0,22134.0,22134.0,22134.0,71013049.95999992,71013049.95999992,ACH,CAD
2025-01-27,Settlement from Amex,Processor Payout Batch,SET-20250123-Amex-Amex-CAD,,0,0,0,38995.17,38995.17,38995.17,71052045.12999992,71052045.12999992,ACH,CAD
2025-01-27,Settlement from Amex,Processor Payout Batch,SET-20250123-Amex-Amex-EUR,,0,0,0,38023.71,38023.71,38023.71,71090068.83999991,71090068.83999991,ACH,EUR
2025-01-27,Settlement from Amex,Processor Payout Batch,SET-20250123-Amex-Amex-GBP,,0,0,0,20224.67,20224.67,20224.67,71110293.50999992,71110293.50999992,ACH,GBP
2025-01-27,Settlement from Amex,Processor Payout Batch,SET-20250123-Amex-Amex-USD,,0,0,0,217395.27,217395.27,217395.27,71327688.77999991,71327688.77999991,ACH,USD
2025-01-27,Settlement from ClientLine,Processor Payout Batch,SET-20250123-ClientLine-Mastercard-AUD,,0,0,0,47901.1,47901.1,47901.1,71375589.8799999,71375589.8799999,ACH,AUD
2025-01-27,Settlement from Amex,Processor Payout Batch,SET-20250123-Amex-Amex-AUD,,0,0,0,19787.71,19787.71,19787.71,71395377.5899999,71395377.5899999,ACH,AUD
2025-01-27,Settlement from ClientLine,Processor Payout Batch,SET-20250123-ClientLine-Mastercard-EUR,,0,0,0,36079.22,36079.22,36079.22,71431456.8099999,71431456.8099999,ACH,EUR
2025-01-27,Settlement from ClientLine,Processor Payout Batch,SET-20250123-ClientLine-Mastercard-GBP,,0,0,0,23417.34,23417.34,23417.34,71454874.1499999,71454874.1499999,ACH,GBP
2025-01-27,Settlement from ClientLine,Processor Payout Batch,SET-20250123-ClientLine-Mastercard-USD,,0,0,0,173616.82,173616.82,173616.82,71628490.9699999,71628490.9699999,ACH,USD
2025-01-27,Settlement from ClientLine,Processor Payout Batch,SET-20250123-ClientLine-Visa-AUD,,0,0,0,45103.98,45103.98,45103.98,71673594.9499999,71673594.9499999,ACH,AUD
2025-01-27,Settlement from ClientLine,Processor Payout Batch,SET-20250123-ClientLine-Mastercard-CAD,,0,0,0,25421.93,25421.93,25421.93,71699016.8799999,71699016.8799999,ACH,CAD
2025-01-28,Settlement from GoCardless,Processor Payout Batch,SET-20250124-GoCardless-N/A-AUD,,0,0,0,99205.59,99205.59,99205.59,71798222.46999991,71798222.46999991,ACH,AUD
2025-01-28,Settlement from GoCardless,Processor Payout Batch,SET-20250124-GoCardless-N/A-CAD,,0,0,0,53587.22,53587.22,53587.22,71851809.68999991,71851809.68999991,ACH,CAD
2025-01-28,Settlement from GoCardless,Processor Payout Batch,SET-20250124-GoCardless-N/A-EUR,,0,0,0,149216.7,149216.7,149216.7,72001026.38999991,72001026.38999991,ACH,EUR
2025-01-28,Settlement from GoCardless,Processor Payout Batch,SET-20250124-GoCardless-N/A-GBP,,0,0,0,90253.85,90253.85,90253.85,72091280.2399999,72091280.2399999,ACH,GBP
2025-01-28,Settlement from GoCardless,Processor Payout Batch,SET-20250124-GoCardless-N/A-USD,,0,0,0,567959.47,567959.47,567959.47,72659239.7099999,72659239.7099999,ACH,USD
2025-01-28,Settlement from PayPal,Processor Payout Batch,SET-20250124-PayPal-N/A-CAD,,0,0,0,56311.02,56311.02,56311.02,72715550.7299999,72715550.7299999,ACH,CAD
2025-01-28,Settlement from PayPal,Processor Payout Batch,SET-20250124-PayPal-N/A-EUR,,0,0,0,137454.06,137454.06,137454.06,72853004.7899999,72853004.7899999,ACH,EUR
2025-01-28,Settlement from PayPal,Processor Payout Batch,SET-20250124-PayPal-N/A-GBP,,0,0,0,86935.93,86935.93,86935.93,72939940.71999991,72939940.71999991,ACH,GBP
2025-01-28,Settlement from PayPal,Processor Payout Batch,SET-20250124-PayPal-N/A-USD,,0,0,0,648021.61,648021.61,648021.61,73587962.32999991,73587962.32999991,ACH,USD
2025-01-28,Settlement from ClientLine,Processor Payout Batch,SET-20250124-ClientLine-Visa-USD,,0,0,0,177339.02,177339.02,177339.02,73765301.3499999,73765301.3499999,ACH,USD
2025-01-28,Settlement from PayPal,Processor Payout Batch,SET-20250124-PayPal-N/A-AUD,,0,0,0,50775.18,50775.18,50775.18,73816076.52999991,73816076.52999991,ACH,AUD
2025-01-28,Settlement from ClientLine,Processor Payout Batch,SET-20250124-ClientLine-Visa-GBP,,0,0,0,35333.51,35333.51,35333.51,73851410.03999992,73851410.03999992,ACH,GBP
2025-01-28,Settlement from ClientLine,Processor Payout Batch,SET-20250124-ClientLine-Mastercard-AUD,,0,0,0,24962.2,24962.2,24962.2,73876372.23999992,73876372.23999992,ACH,AUD
2025-01-28,Settlement from ClientLine,Processor Payout Batch,SET-20250124-ClientLine-Visa-CAD,,0,0,0,33137.67,33137.67,33137.67,73909509.90999992,73909509.90999992,ACH,CAD
2025-01-28,Settlement from ClientLine,Processor Payout Batch,SET-20250124-ClientLine-Visa-EUR,,0,0,0,34799.31,34799.31,34799.31,73944309.21999992,73944309.21999992,ACH,EUR
2025-01-28,Settlement from Amex,Processor Payout Batch,SET-20250124-Amex-Amex-CAD,,0,0,0,27859.84,27859.84,27859.84,73972169.05999993,73972169.05999993,ACH,CAD
2025-01-28,Settlement from Amex,Processor Payout Batch,SET-20250124-Amex-Amex-EUR,,0,0,0,52736.37,52736.37,52736.37,74024905.42999993,74024905.42999993,ACH,EUR
2025-01-28,Settlement from Amex,Processor Payout Batch,SET-20250124-Amex-Amex-GBP,,0,0,0,21787.71,21787.71,21787.71,74046693.13999993,74046693.13999993,ACH,GBP
2025-01-28,Settlement from Amex,Processor Payout Batch,SET-20250124-Amex-Amex-USD,,0,0,0,236882.34,236882.34,236882.34,74283575.47999993,74283575.47999993,ACH,USD
2025-01-28,Settlement from Amex,Processor Payout Batch,SET-20250124-Amex-Amex-AUD,,0,0,0,26970.87,26970.87,26970.87,74310546.34999993,74310546.34999993,ACH,AUD
2025-01-28,Settlement from ClientLine,Processor Payout Batch,SET-20250124-ClientLine-Mastercard-CAD,,0,0,0,15867.86,15867.86,15867.86,74326414.20999993,74326414.20999993,ACH,CAD
2025-01-28,Settlement from ClientLine,Processor Payout Batch,SET-20250124-ClientLine-Mastercard-EUR,,0,0,0,46643.42,46643.42,46643.42,74373057.62999994,74373057.62999994,ACH,EUR
2025-01-28,Settlement from ClientLine,Processor Payout Batch,SET-20250124-ClientLine-Mastercard-GBP,,0,0,0,32307.88,32307.88,32307.88,74405365.50999993,74405365.50999993,ACH,GBP
2025-01-28,Settlement from ClientLine,Processor Payout Batch,SET-20250124-ClientLine-Mastercard-USD,,0,0,0,200211.38,200211.38,200211.38,74605576.88999993,74605576.88999993,ACH,USD
2025-01-28,Settlement from ClientLine,Processor Payout Batch,SET-20250124-ClientLine-Visa-AUD,,0,0,0,20375.63,20375.63,20375.63,74625952.51999992,74625952.51999992,ACH,AUD
2025-01-29,Settlement from ClientLine,Processor Payout Batch,SET-20250127-ClientLine-Mastercard-USD,,0,0,0,192337.69,192337.69,192337.69,74818290.20999992,74818290.20999992,ACH,USD
2025-01-29,Settlement from Amex,Processor Payout Batch,SET-20250127-Amex-Amex-CAD,,0,0,0,9731.6,9731.6,9731.6,74828021.80999991,74828021.80999991,ACH,CAD
2025-01-29,Settlement from Amex,Processor Payout Batch,SET-20250127-Amex-Amex-EUR,,0,0,0,43221.94,43221.94,43221.94,74871243.74999991,74871243.74999991,ACH,EUR
2025-01-29,Settlement from Amex,Processor Payout Batch,SET-20250127-Amex-Amex-GBP,,0,0,0,37161.28,37161.28,37161.28,74908405.02999991,74908405.02999991,ACH,GBP
2025-01-29,Settlement from Amex,Processor Payout Batch,SET-20250127-Amex-Amex-USD,,0,0,0,197597.29,197597.29,197597.29,75106002.31999992,75106002.31999992,ACH,USD
2025-01-29,Settlement from ClientLine,Processor Payout Batch,SET-20250127-ClientLine-Mastercard-AUD,,0,0,0,29303.07,29303.07,29303.07,75135305.38999991,75135305.38999991,ACH,AUD
2025-01-29,Settlement from ClientLine,Processor Payout Batch,SET-20250127-ClientLine-Mastercard-CAD,,0,0,0,17084.97,17084.97,17084.97,75152390.35999991,75152390.35999991,ACH,CAD
2025-01-29,Settlement from ClientLine,Processor Payout Batch,SET-20250127-ClientLine-Mastercard-EUR,,0,0,0,57003.87,57003.87,57003.87,75209394.22999991,75209394.22999991,ACH,EUR
2025-01-29,Settlement from ClientLine,Processor Payout Batch,SET-20250127-ClientLine-Mastercard-GBP,,0,0,0,20708.76,20708.76,20708.76,75230102.98999992,75230102.98999992,ACH,GBP
2025-01-29,Settlement from Amex,Processor Payout Batch,SET-20250127-Amex-Amex-AUD,,0,0,0,31310.46,31310.46,31310.46,75261413.44999991,75261413.44999991,ACH,AUD
2025-01-29,Settlement from ClientLine,Processor Payout Batch,SET-20250127-ClientLine-Visa-AUD,,0,0,0,28729.36,28729.36,28729.36,75290142.80999991,75290142.80999991,ACH,AUD
2025-01-29,Settlement from GoCardless,Processor Payout Batch,SET-20250127-GoCardless-N/A-CAD,,0,0,0,68554.42,68554.42,68554.42,75358697.22999991,75358697.22999991,ACH,CAD
2025-01-29,Settlement from ClientLine,Processor Payout Batch,SET-20250127-ClientLine-Visa-EUR,,0,0,0,70620.45,70620.45,70620.45,75429317.67999992,75429317.67999992,ACH,EUR
2025-01-29,Settlement from ClientLine,Processor Payout Batch,SET-20250127-ClientLine-Visa-GBP,,0,0,0,36300.57,36300.57,36300.57,75465618.24999991,75465618.24999991,ACH,GBP
2025-01-29,Settlement from ClientLine,Processor Payout Batch,SET-20250127-ClientLine-Visa-USD,,0,0,0,191673.14,191673.14,191673.14,75657291.38999991,75657291.38999991,ACH,USD
2025-01-29,Settlement from GoCardless,Processor Payout Batch,SET-20250127-GoCardless-N/A-AUD,,0,0,0,80982.58,80982.58,80982.58,75738273.96999991,75738273.96999991,ACH,AUD
2025-01-29,Settlement from GoCardless,Processor Payout Batch,SET-20250127-GoCardless-N/A-EUR,,0,0,0,182783.23,182783.23,182783.23,75921057.19999991,75921057.19999991,ACH,EUR
2025-01-29,Settlement from GoCardless,Processor Payout Batch,SET-20250127-GoCardless-N/A-GBP,,0,0,0,106361.65,106361.65,106361.65,76027418.84999992,76027418.84999992,ACH,GBP
2025-01-29,Settlement from GoCardless,Processor Payout Batch,SET-20250127-GoCardless-N/A-USD,,0,0,0,677733.74,677733.74,677733.74,76705152.58999991,76705152.58999991,ACH,USD
2025-01-29,Settlement from PayPal,Processor Payout Batch,SET-20250127-PayPal-N/A-AUD,,0,0,0,71410.69,71410.69,71410.69,76776563.27999991,76776563.27999991,ACH,AUD
2025-01-29,Settlement from PayPal,Processor Payout Batch,SET-20250127-PayPal-N/A-CAD,,0,0,0,61797.22,61797.22,61797.22,76838360.49999991,76838360.49999991,ACH,CAD
2025-01-29,Settlement from PayPal,Processor Payout Batch,SET-20250127-PayPal-N/A-USD,,0,0,0,559477.66,559477.66,559477.66,77397838.1599999,77397838.1599999,ACH,USD
2025-01-29,Settlement from ClientLine,Processor Payout Batch,SET-20250127-ClientLine-Visa-CAD,,0,0,0,17384.81,17384.81,17384.81,77415222.96999991,77415222.96999991,ACH,CAD
2025-01-29,Settlement from PayPal,Processor Payout Batch,SET-20250125-PayPal-N/A-USD,,0,0,0,671852.85,671852.85,671852.85,78087075.8199999,78087075.8199999,ACH,USD
2025-01-29,Settlement from ClientLine,Processor Payout Batch,SET-20250125-ClientLine-Mastercard-AUD,,0,0,0,48924.48,48924.48,48924.48,78136000.29999991,78136000.29999991,ACH,AUD
2025-01-29,Settlement from PayPal,Processor Payout Batch,SET-20250125-PayPal-N/A-EUR,,0,0,0,133639.24,133639.24,133639.24,78269639.5399999,78269639.5399999,ACH,EUR
2025-01-29,Settlement from PayPal,Processor Payout Batch,SET-20250125-PayPal-N/A-AUD,,0,0,0,100362.06,100362.06,100362.06,78370001.5999999,78370001.5999999,ACH,AUD
2025-01-29,Settlement from GoCardless,Processor Payout Batch,SET-20250125-GoCardless-N/A-USD,,0,0,0,661900.67,661900.67,661900.67,79031902.2699999,79031902.2699999,ACH,USD
2025-01-29,Settlement from GoCardless,Processor Payout Batch,SET-20250125-GoCardless-N/A-GBP,,0,0,0,116786.45,116786.45,116786.45,79148688.71999991,79148688.71999991,ACH,GBP
2025-01-29,Settlement from GoCardless,Processor Payout Batch,SET-20250125-GoCardless-N/A-EUR,,0,0,0,175183.4,175183.4,175183.4,79323872.11999992,79323872.11999992,ACH,EUR
2025-01-29,Settlement from GoCardless,Processor Payout Batch,SET-20250125-GoCardless-N/A-CAD,,0,0,0,86009.99,86009.99,86009.99,79409882.10999991,79409882.10999991,ACH,CAD
2025-01-29,Settlement from GoCardless,Processor Payout Batch,SET-20250125-GoCardless-N/A-AUD,,0,0,0,59320.77,59320.77,59320.77,79469202.8799999,79469202.8799999,ACH,AUD
2025-01-29,Settlement from ClientLine,Processor Payout Batch,SET-20250125-ClientLine-Visa-USD,,0,0,0,201724.15,201724.15,201724.15,79670927.02999991,79670927.02999991,ACH,USD
2025-01-29,Settlement from ClientLine,Processor Payout Batch,SET-20250125-ClientLine-Visa-GBP,,0,0,0,32682.14,32682.14,32682.14,79703609.16999991,79703609.16999991,ACH,GBP
2025-01-29,Settlement from ClientLine,Processor Payout Batch,SET-20250125-ClientLine-Visa-EUR,,0,0,0,35856.17,35856.17,35856.17,79739465.33999991,79739465.33999991,ACH,EUR
2025-01-29,Settlement from ClientLine,Processor Payout Batch,SET-20250125-ClientLine-Visa-CAD,,0,0,0,35029.73,35029.73,35029.73,79774495.06999992,79774495.06999992,ACH,CAD
2025-01-29,Settlement from ClientLine,Processor Payout Batch,SET-20250125-ClientLine-Visa-AUD,,0,0,0,18415.56,18415.56,18415.56,79792910.62999992,79792910.62999992,ACH,AUD
2025-01-29,Settlement from ClientLine,Processor Payout Batch,SET-20250125-ClientLine-Mastercard-USD,,0,0,0,210613.7,210613.7,210613.7,80003524.32999992,80003524.32999992,ACH,USD
2025-01-29,Settlement from ClientLine,Processor Payout Batch,SET-20250125-ClientLine-Mastercard-GBP,,0,0,0,25217.42,25217.42,25217.42,80028741.74999993,80028741.74999993,ACH,GBP
2025-01-29,Settlement from ClientLine,Processor Payout Batch,SET-20250125-ClientLine-Mastercard-EUR,,0,0,0,39528.85,39528.85,39528.85,80068270.59999992,80068270.59999992,ACH,EUR
2025-01-29,Settlement from ClientLine,Processor Payout Batch,SET-20250125-ClientLine-Mastercard-CAD,,0,0,0,24609.64,24609.64,24609.64,80092880.23999992,80092880.23999992,ACH,CAD
2025-01-29,Settlement from PayPal,Processor Payout Batch,SET-20250127-PayPal-N/A-EUR,,0,0,0,134411.03,134411.03,134411.03,80227291.26999992,80227291.26999992,ACH,EUR
2025-01-29,Settlement from Amex,Processor Payout Batch,SET-20250125-Amex-Amex-USD,,0,0,0,217956.97,217956.97,217956.97,80445248.23999992,80445248.23999992,ACH,USD
2025-01-29,Settlement from Amex,Processor Payout Batch,SET-20250125-Amex-Amex-GBP,,0,0,0,30953.6,30953.6,30953.6,80476201.83999991,80476201.83999991,ACH,GBP
2025-01-29,Settlement from Amex,Processor Payout Batch,SET-20250125-Amex-Amex-EUR,,0,0,0,46210.32,46210.32,46210.32,80522412.1599999,80522412.1599999,ACH,EUR
2025-01-29,Settlement from Amex,Processor Payout Batch,SET-20250125-Amex-Amex-CAD,,0,0,0,41614.74,41614.74,41614.74,80564026.8999999,80564026.8999999,ACH,CAD
2025-01-29,Settlement from Amex,Processor Payout Batch,SET-20250125-Amex-Amex-AUD,,0,0,0,32767.29,32767.29,32767.29,80596794.18999991,80596794.18999991,ACH,AUD
2025-01-29,Settlement from PayPal,Processor Payout Batch,SET-20250125-PayPal-N/A-CAD,,0,0,0,72949.19,72949.19,72949.19,80669743.3799999,80669743.3799999,ACH,CAD
2025-01-29,Settlement from PayPal,Processor Payout Batch,SET-20250125-PayPal-N/A-GBP,,0,0,0,99690.26,99690.26,99690.26,80769433.63999991,80769433.63999991,ACH,GBP
2025-01-29,Settlement from PayPal,Processor Payout Batch,SET-20250127-PayPal-N/A-GBP,,0,0,0,96364.21,96364.21,96364.21,80865797.8499999,80865797.8499999,ACH,GBP
2025-01-30,Settlement from Amex,Processor Payout Batch,SET-20250128-Amex-Amex-CAD,,0,0,0,28052.08,28052.08,28052.08,80893849.9299999,80893849.9299999,ACH,CAD
2025-01-30,Settlement from PayPal,Processor Payout Batch,SET-20250128-PayPal-N/A-GBP,,0,0,0,114203.6,114203.6,114203.6,81008053.5299999,81008053.5299999,ACH,GBP
2025-01-30,Settlement from PayPal,Processor Payout Batch,SET-20250128-PayPal-N/A-EUR,,0,0,0,140609.7,140609.7,140609.7,81148663.2299999,81148663.2299999,ACH,EUR
2025-01-30,Settlement from PayPal,Processor Payout Batch,SET-20250128-PayPal-N/A-CAD,,0,0,0,74047.28,74047.28,74047.28,81222710.5099999,81222710.5099999,ACH,CAD
2025-01-30,Settlement from PayPal,Processor Payout Batch,SET-20250128-PayPal-N/A-AUD,,0,0,0,42362.41,42362.41,42362.41,81265072.9199999,81265072.9199999,ACH,AUD
2025-01-30,Settlement from GoCardless,Processor Payout Batch,SET-20250128-GoCardless-N/A-USD,,0,0,0,687151.1,687151.1,687151.1,81952224.01999989,81952224.01999989,ACH,USD
2025-01-30,Settlement from GoCardless,Processor Payout Batch,SET-20250128-GoCardless-N/A-EUR,,0,0,0,105014.3,105014.3,105014.3,82057238.31999989,82057238.31999989,ACH,EUR
2025-01-30,Settlement from GoCardless,Processor Payout Batch,SET-20250128-GoCardless-N/A-CAD,,0,0,0,81201.29,81201.29,81201.29,82138439.6099999,82138439.6099999,ACH,CAD
2025-01-30,Settlement from GoCardless,Processor Payout Batch,SET-20250128-GoCardless-N/A-AUD,,0,0,0,101616.31,101616.31,101616.31,82240055.9199999,82240055.9199999,ACH,AUD
2025-01-30,Settlement from ClientLine,Processor Payout Batch,SET-20250128-ClientLine-Visa-USD,,0,0,0,248949.35,248949.35,248949.35,82489005.26999989,82489005.26999989,ACH,USD
2025-01-30,Settlement from ClientLine,Processor Payout Batch,SET-20250128-ClientLine-Visa-GBP,,0,0,0,22919.51,22919.51,22919.51,82511924.7799999,82511924.7799999,ACH,GBP
2025-01-30,Settlement from ClientLine,Processor Payout Batch,SET-20250128-ClientLine-Visa-EUR,,0,0,0,73207.13,73207.13,73207.13,82585131.90999989,82585131.90999989,ACH,EUR
2025-01-30,Settlement from ClientLine,Processor Payout Batch,SET-20250128-ClientLine-Visa-CAD,,0,0,0,24631.34,24631.34,24631.34,82609763.2499999,82609763.2499999,ACH,CAD
2025-01-30,Settlement from ClientLine,Processor Payout Batch,SET-20250128-ClientLine-Visa-AUD,,0,0,0,20998.22,20998.22,20998.22,82630761.4699999,82630761.4699999,ACH,AUD
2025-01-30,Settlement from ClientLine,Processor Payout Batch,SET-20250128-ClientLine-Mastercard-USD,,0,0,0,188570.47,188570.47,188570.47,82819331.9399999,82819331.9399999,ACH,USD
2025-01-30,Settlement from ClientLine,Processor Payout Batch,SET-20250128-ClientLine-Mastercard-GBP,,0,0,0,26183.1,26183.1,26183.1,82845515.03999989,82845515.03999989,ACH,GBP
2025-01-30,Settlement from ClientLine,Processor Payout Batch,SET-20250128-ClientLine-Mastercard-EUR,,0,0,0,57253.46,57253.46,57253.46,82902768.49999988,82902768.49999988,ACH,EUR
2025-01-30,Settlement from ClientLine,Processor Payout Batch,SET-20250128-ClientLine-Mastercard-CAD,,0,0,0,30682.1,30682.1,30682.1,82933450.59999987,82933450.59999987,ACH,CAD
2025-01-30,Settlement from ClientLine,Processor Payout Batch,SET-20250128-ClientLine-Mastercard-AUD,,0,0,0,21147.16,21147.16,21147.16,82954597.75999987,82954597.75999987,ACH,AUD
2025-01-30,Settlement from Amex,Processor Payout Batch,SET-20250128-Amex-Amex-USD,,0,0,0,214012.47,214012.47,214012.47,83168610.22999987,83168610.22999987,ACH,USD
2025-01-30,Settlement from Amex,Processor Payout Batch,SET-20250128-Amex-Amex-GBP,,0,0,0,18148.0,18148.0,18148.0,83186758.22999987,83186758.22999987,ACH,GBP
2025-01-30,Settlement from Amex,Processor Payout Batch,SET-20250128-Amex-Amex-EUR,,0,0,0,46574.68,46574.68,46574.68,83233332.90999988,83233332.90999988,ACH,EUR
2025-01-30,Settlement from Amex,Processor Payout Batch,SET-20250128-Amex-Amex-AUD,,0,0,0,18064.38,18064.38,18064.38,83251397.28999987,83251397.28999987,ACH,AUD
2025-01-30,Settlement from PayPal,Processor Payout Batch,SET-20250128-PayPal-N/A-USD,,0,0,0,603148.64,603148.64,603148.64,83854545.92999987,83854545.92999987,ACH,USD
2025-01-30,Settlement from GoCardless,Processor Payout Batch,SET-20250128-GoCardless-N/A-GBP,,0,0,0,130422.91,130422.91,130422.91,83984968.83999987,83984968.83999987,ACH,GBP
2025-01-30,Settlement from PayPal,Processor Payout Batch,SET-20250126-PayPal-N/A-GBP,,0,0,0,105251.29,105251.29,105251.29,84090220.12999988,84090220.12999988,ACH,GBP
2025-01-30,Settlement from Amex,Processor Payout Batch,SET-20250126-Amex-Amex-AUD,,0,0,0,27599.26,27599.26,27599.26,84117819.38999988,84117819.38999988,ACH,AUD
2025-01-30,Settlement from Amex,Processor Payout Batch,SET-20250126-Amex-Amex-CAD,,0,0,0,17618.87,17618.87,17618.87,84135438.25999989,84135438.25999989,ACH,CAD
2025-01-30,Settlement from Amex,Processor Payout Batch,SET-20250126-Amex-Amex-EUR,,0,0,0,43021.28,43021.28,43021.28,84178459.53999989,84178459.53999989,ACH,EUR
2025-01-30,Settlement from Amex,Processor Payout Batch,SET-20250126-Amex-Amex-GBP,,0,0,0,34888.34,34888.34,34888.34,84213347.87999989,84213347.87999989,ACH,GBP
2025-01-30,Settlement from Amex,Processor Payout Batch,SET-20250126-Amex-Amex-USD,,0,0,0,161768.5,161768.5,161768.5,84375116.37999989,84375116.37999989,ACH,USD
2025-01-30,Settlement from ClientLine,Processor Payout Batch,SET-20250126-ClientLine-Mastercard-AUD,,0,0,0,20689.97,20689.97,20689.97,84395806.34999989,84395806.34999989,ACH,AUD
2025-01-30,Settlement from ClientLine,Processor Payout Batch,SET-20250126-ClientLine-Mastercard-CAD,,0,0,0,29821.02,29821.02,29821.02,84425627.36999989,84425627.36999989,ACH,CAD
2025-01-30,Settlement from ClientLine,Processor Payout Batch,SET-20250126-ClientLine-Mastercard-EUR,,0,0,0,41185.01,41185.01,41185.01,84466812.37999989,84466812.37999989,ACH,EUR
2025-01-30,Settlement from ClientLine,Processor Payout Batch,SET-20250126-ClientLine-Mastercard-GBP,,0,0,0,31300.79,31300.79,31300.79,84498113.1699999,84498113.1699999,ACH,GBP
2025-01-30,Settlement from ClientLine,Processor Payout Batch,SET-20250126-ClientLine-Mastercard-USD,,0,0,0,198250.74,198250.74,198250.74,84696363.90999989,84696363.90999989,ACH,USD
2025-01-30,Settlement from ClientLine,Processor Payout Batch,SET-20250126-ClientLine-Visa-AUD,,0,0,0,25936.73,25936.73,25936.73,84722300.6399999,84722300.6399999,ACH,AUD
2025-01-30,Settlement from PayPal,Processor Payout Batch,SET-20250126-PayPal-N/A-USD,,0,0,0,658502.1,658502.1,658502.1,85380802.73999989,85380802.73999989,ACH,USD
2025-01-30,Settlement from ClientLine,Processor Payout Batch,SET-20250126-ClientLine-Visa-EUR,,0,0,0,28899.06,28899.06,28899.06,85409701.7999999,85409701.7999999,ACH,EUR
2025-01-30,Settlement from PayPal,Processor Payout Batch,SET-20250126-PayPal-N/A-CAD,,0,0,0,71138.59,71138.59,71138.59,85480840.3899999,85480840.3899999,ACH,CAD
2025-01-30,Settlement from PayPal,Processor Payout Batch,SET-20250126-PayPal-N/A-AUD,,0,0,0,81632.43,81632.43,81632.43,85562472.8199999,85562472.8199999,ACH,AUD
2025-01-30,Settlement from GoCardless,Processor Payout Batch,SET-20250126-GoCardless-N/A-USD,,0,0,0,633012.42,633012.42,633012.42,86195485.2399999,86195485.2399999,ACH,USD
2025-01-30,Settlement from GoCardless,Processor Payout Batch,SET-20250126-GoCardless-N/A-GBP,,0,0,0,107233.63,107233.63,107233.63,86302718.8699999,86302718.8699999,ACH,GBP
2025-01-30,Settlement from GoCardless,Processor Payout Batch,SET-20250126-GoCardless-N/A-EUR,,0,0,0,178644.36,178644.36,178644.36,86481363.2299999,86481363.2299999,ACH,EUR
2025-01-30,Settlement from PayPal,Processor Payout Batch,SET-20250126-PayPal-N/A-EUR,,0,0,0,126805.73,126805.73,126805.73,86608168.9599999,86608168.9599999,ACH,EUR
2025-01-30,Settlement from GoCardless,Processor Payout Batch,SET-20250126-GoCardless-N/A-CAD,,0,0,0,97634.27,97634.27,97634.27,86705803.2299999,86705803.2299999,ACH,CAD
2025-01-30,Settlement from GoCardless,Processor Payout Batch,SET-20250126-GoCardless-N/A-AUD,,0,0,0,106827.68,106827.68,106827.68,86812630.9099999,86812630.9099999,ACH,AUD
2025-01-30,Settlement from ClientLine,Processor Payout Batch,SET-20250126-ClientLine-Visa-USD,,0,0,0,205591.76,205591.76,205591.76,87018222.66999991,87018222.66999991,ACH,USD
2025-01-30,Settlement from ClientLine,Processor Payout Batch,SET-20250126-ClientLine-Visa-GBP,,0,0,0,18498.98,18498.98,18498.98,87036721.64999992,87036721.64999992,ACH,GBP
2025-01-30,Settlement from ClientLine,Processor Payout Batch,SET-20250126-ClientLine-Visa-CAD,,0,0,0,35027.29,35027.29,35027.29,87071748.93999992,87071748.93999992,ACH,CAD
2025-01-31,Settlement from ClientLine,Processor Payout Batch,SET-20250129-ClientLine-Visa-GBP,,0,0,0,30976.22,30976.22,30976.22,87102725.15999992,87102725.15999992,ACH,GBP
2025-01-31,Settlement from PayPal,Processor Payout Batch,SET-20250129-PayPal-N/A-GBP,,0,0,0,83428.99,83428.99,83428.99,87186154.14999992,87186154.14999992,ACH,GBP
2025-01-31,Settlement from PayPal,Processor Payout Batch,SET-20250129-PayPal-N/A-EUR,,0,0,0,176857.08,176857.08,176857.08,87363011.22999991,87363011.22999991,ACH,EUR
2025-01-31,Settlement from PayPal,Processor Payout Batch,SET-20250129-PayPal-N/A-CAD,,0,0,0,53384.78,53384.78,53384.78,87416396.00999992,87416396.00999992,ACH,CAD
2025-01-31,Settlement from PayPal,Processor Payout Batch,SET-20250129-PayPal-N/A-AUD,,0,0,0,79865.56,79865.56,79865.56,87496261.56999992,87496261.56999992,ACH,AUD
2025-01-31,Settlement from GoCardless,Processor Payout Batch,SET-20250129-GoCardless-N/A-USD,,0,0,0,634898.8,634898.8,634898.8,88131160.36999992,88131160.36999992,ACH,USD
2025-01-31,Settlement from GoCardless,Processor Payout Batch,SET-20250129-GoCardless-N/A-EUR,,0,0,0,124577.68,124577.68,124577.68,88255738.04999992,88255738.04999992,ACH,EUR
2025-01-31,Settlement from GoCardless,Processor Payout Batch,SET-20250129-GoCardless-N/A-CAD,,0,0,0,45905.65,45905.65,45905.65,88301643.69999993,88301643.69999993,ACH,CAD
2025-01-31,Settlement from GoCardless,Processor Payout Batch,SET-20250129-GoCardless-N/A-AUD,,0,0,0,72232.54,72232.54,72232.54,88373876.23999994,88373876.23999994,ACH,AUD
2025-01-31,Settlement from ClientLine,Processor Payout Batch,SET-20250129-ClientLine-Visa-USD,,0,0,0,208792.0,208792.0,208792.0,88582668.23999994,88582668.23999994,ACH,USD
2025-01-31,Settlement from ClientLine,Processor Payout Batch,SET-20250129-ClientLine-Visa-EUR,,0,0,0,55068.63,55068.63,55068.63,88637736.86999993,88637736.86999993,ACH,EUR
2025-01-31,Settlement from PayPal,Processor Payout Batch,SET-20250129-PayPal-N/A-USD,,0,0,0,507800.53,507800.53,507800.53,89145537.39999993,89145537.39999993,ACH,USD
2025-01-31,Settlement from ClientLine,Processor Payout Batch,SET-20250129-ClientLine-Visa-AUD,,0,0,0,14709.46,14709.46,14709.46,89160246.85999992,89160246.85999992,ACH,AUD
2025-01-31,Settlement from ClientLine,Processor Payout Batch,SET-20250129-ClientLine-Visa-CAD,,0,0,0,22047.61,22047.61,22047.61,89182294.46999992,89182294.46999992,ACH,CAD
2025-01-31,Settlement from Amex,Processor Payout Batch,SET-20250129-Amex-Amex-AUD,,0,0,0,29413.38,29413.38,29413.38,89211707.84999992,89211707.84999992,ACH,AUD
2025-01-31,Settlement from Amex,Processor Payout Batch,SET-20250129-Amex-Amex-CAD,,0,0,0,16692.5,16692.5,16692.5,89228400.34999992,89228400.34999992,ACH,CAD
2025-01-31,Settlement from Amex,Processor Payout Batch,SET-20250129-Amex-Amex-EUR,,0,0,0,61374.79,61374.79,61374.79,89289775.13999993,89289775.13999993,ACH,EUR
2025-01-31,Settlement from Amex,Processor Payout Batch,SET-20250129-Amex-Amex-GBP,,0,0,0,35204.56,35204.56,35204.56,89324979.69999993,89324979.69999993,ACH,GBP
2025-01-31,Settlement from Amex,Processor Payout Batch,SET-20250129-Amex-Amex-USD,,0,0,0,200846.57,200846.57,200846.57,89525826.26999992,89525826.26999992,ACH,USD
2025-01-31,Settlement from GoCardless,Processor Payout Batch,SET-20250129-GoCardless-N/A-GBP,,0,0,0,108925.04,108925.04,108925.04,89634751.30999993,89634751.30999993,ACH,GBP
2025-01-31,Settlement from ClientLine,Processor Payout Batch,SET-20250129-ClientLine-Mastercard-AUD,,0,0,0,17422.61,17422.61,17422.61,89652173.91999993,89652173.91999993,ACH,AUD
2025-01-31,Settlement from ClientLine,Processor Payout Batch,SET-20250129-ClientLine-Mastercard-GBP,,0,0,0,34443.33,34443.33,34443.33,89686617.24999993,89686617.24999993,ACH,GBP
2025-01-31,Settlement from ClientLine,Processor Payout Batch,SET-20250129-ClientLine-Mastercard-USD,,0,0,0,255470.46,255470.46,255470.46,89942087.70999992,89942087.70999992,ACH,USD
2025-01-31,Settlement from ClientLine,Processor Payout Batch,SET-20250129-ClientLine-Mastercard-CAD,,0,0,0,43653.32,43653.32,43653.32,89985741.02999991,89985741.02999991,ACH,CAD
2025-01-31,Settlement from ClientLine,Processor Payout Batch,SET-20250129-ClientLine-Mastercard-EUR,,0,0,0,32212.59,32212.59,32212.59,90017953.61999992,90017953.61999992,ACH,EUR
2025-02-03,Settlement from PayPal,Processor Payout Batch,SET-20250130-PayPal-N/A-USD,,0,0,0,584871.77,584871.77,584871.77,90602825.38999991,90602825.38999991,ACH,USD
2025-02-03,Settlement from PayPal,Processor Payout Batch,SET-20250130-PayPal-N/A-GBP,,0,0,0,83502.81,83502.81,83502.81,90686328.19999991,90686328.19999991,ACH,GBP
2025-02-03,Settlement from PayPal,Processor Payout Batch,SET-20250130-PayPal-N/A-EUR,,0,0,0,174290.66,174290.66,174290.66,90860618.85999991,90860618.85999991,ACH,EUR
2025-02-03,Settlement from PayPal,Processor Payout Batch,SET-20250130-PayPal-N/A-CAD,,0,0,0,96847.83,96847.83,96847.83,90957466.68999991,90957466.68999991,ACH,CAD
2025-02-03,Settlement from ClientLine,Processor Payout Batch,SET-20250130-ClientLine-Visa-EUR,,0,0,0,39695.06,39695.06,39695.06,90997161.74999991,90997161.74999991,ACH,EUR
2025-02-03,Settlement from GoCardless,Processor Payout Batch,SET-20250130-GoCardless-N/A-USD,,0,0,0,562043.61,562043.61,562043.61,91559205.35999991,91559205.35999991,ACH,USD
2025-02-03,Settlement from GoCardless,Processor Payout Batch,SET-20250130-GoCardless-N/A-GBP,,0,0,0,76123.53,76123.53,76123.53,91635328.88999991,91635328.88999991,ACH,GBP
2025-02-03,Settlement from GoCardless,Processor Payout Batch,SET-20250130-GoCardless-N/A-EUR,,0,0,0,149287.25,149287.25,149287.25,91784616.13999991,91784616.13999991,ACH,EUR
2025-02-03,Settlement from GoCardless,Processor Payout Batch,SET-20250130-GoCardless-N/A-CAD,,0,0,0,76332.05,76332.05,76332.05,91860948.18999991,91860948.18999991,ACH,CAD
2025-02-03,Settlement from ClientLine,Processor Payout Batch,SET-20250130-ClientLine-Visa-USD,,0,0,0,241571.97,241571.97,241571.97,92102520.1599999,92102520.1599999,ACH,USD
2025-02-03,Settlement from ClientLine,Processor Payout Batch,SET-20250130-ClientLine-Visa-GBP,,0,0,0,41695.63,41695.63,41695.63,92144215.7899999,92144215.7899999,ACH,GBP
2025-02-03,Settlement from PayPal,Processor Payout Batch,SET-20250130-PayPal-N/A-AUD,,0,0,0,87879.25,87879.25,87879.25,92232095.0399999,92232095.0399999,ACH,AUD
2025-02-03,Settlement from GoCardless,Processor Payout Batch,SET-20250130-GoCardless-N/A-AUD,,0,0,0,81427.94,81427.94,81427.94,92313522.9799999,92313522.9799999,ACH,AUD
2025-02-03,Settlement from ClientLine,Processor Payout Batch,SET-20250130-ClientLine-Mastercard-USD,,0,0,0,194536.84,194536.84,194536.84,92508059.8199999,92508059.8199999,ACH,USD
2025-02-03,Settlement from ClientLine,Processor Payout Batch,SET-20250130-ClientLine-Visa-AUD,,0,0,0,22930.6,22930.6,22930.6,92530990.4199999,92530990.4199999,ACH,AUD
2025-02-03,Settlement from Amex,Processor Payout Batch,SET-20250130-Amex-Amex-AUD,,0,0,0,26541.31,26541.31,26541.31,92557531.7299999,92557531.7299999,ACH,AUD
2025-02-03,Settlement from Amex,Processor Payout Batch,SET-20250130-Amex-Amex-CAD,,0,0,0,30734.77,30734.77,30734.77,92588266.4999999,92588266.4999999,ACH,CAD
2025-02-03,Settlement from Amex,Processor Payout Batch,SET-20250130-Amex-Amex-EUR,,0,0,0,67026.36,67026.36,67026.36,92655292.8599999,92655292.8599999,ACH,EUR
2025-02-03,Settlement from Amex,Processor Payout Batch,SET-20250130-Amex-Amex-GBP,,0,0,0,29466.64,29466.64,29466.64,92684759.4999999,92684759.4999999,ACH,GBP
2025-02-03,Settlement from ClientLine,Processor Payout Batch,SET-20250130-ClientLine-Visa-CAD,,0,0,0,51750.51,51750.51,51750.51,92736510.0099999,92736510.0099999,ACH,CAD
2025-02-03,Settlement from ClientLine,Processor Payout Batch,SET-20250130-ClientLine-Mastercard-AUD,,0,0,0,30343.02,30343.02,30343.02,92766853.0299999,92766853.0299999,ACH,AUD
2025-02-03,Settlement from ClientLine,Processor Payout Batch,SET-20250130-ClientLine-Mastercard-CAD,,0,0,0,12563.63,12563.63,12563.63,92779416.65999989,92779416.65999989,ACH,CAD
2025-02-03,Settlement from ClientLine,Processor Payout Batch,SET-20250130-ClientLine-Mastercard-EUR,,0,0,0,54734.4,54734.4,54734.4,92834151.0599999,92834151.0599999,ACH,EUR
2025-02-03,Settlement from ClientLine,Processor Payout Batch,SET-20250130-ClientLine-Mastercard-GBP,,0,0,0,60253.41,60253.41,60253.41,92894404.4699999,92894404.4699999,ACH,GBP
2025-02-03,Settlement from Amex,Processor Payout Batch,SET-20250130-Amex-Amex-USD,,0,0,0,233775.05,233775.05,233775.05,93128179.51999989,93128179.51999989,ACH,USD
2025-02-04,Settlement from ClientLine,Processor Payout Batch,SET-20250131-ClientLine-Visa-USD,,0,0,0,224212.99,224212.99,224212.99,93352392.50999989,93352392.50999989,ACH,USD
2025-02-04,Settlement from GoCardless,Processor Payout Batch,SET-20250131-GoCardless-N/A-AUD,,0,0,0,94492.23,94492.23,94492.23,93446884.73999989,93446884.73999989,ACH,AUD
2025-02-04,Settlement from GoCardless,Processor Payout Batch,SET-20250131-GoCardless-N/A-CAD,,0,0,0,47869.64,47869.64,47869.64,93494754.37999989,93494754.37999989,ACH,CAD
2025-02-04,Settlement from GoCardless,Processor Payout Batch,SET-20250131-GoCardless-N/A-EUR,,0,0,0,147548.69,147548.69,147548.69,93642303.06999989,93642303.06999989,ACH,EUR
2025-02-04,Settlement from GoCardless,Processor Payout Batch,SET-20250131-GoCardless-N/A-GBP,,0,0,0,114316.66,114316.66,114316.66,93756619.72999988,93756619.72999988,ACH,GBP
2025-02-04,Settlement from PayPal,Processor Payout Batch,SET-20250131-PayPal-N/A-AUD,,0,0,0,117057.91,117057.91,117057.91,93873677.63999988,93873677.63999988,ACH,AUD
2025-02-04,Settlement from PayPal,Processor Payout Batch,SET-20250131-PayPal-N/A-CAD,,0,0,0,60189.07,60189.07,60189.07,93933866.70999987,93933866.70999987,ACH,CAD
2025-02-04,Settlement from PayPal,Processor Payout Batch,SET-20250131-PayPal-N/A-EUR,,0,0,0,165876.22,165876.22,165876.22,94099742.92999987,94099742.92999987,ACH,EUR
2025-02-04,Settlement from PayPal,Processor Payout Batch,SET-20250131-PayPal-N/A-GBP,,0,0,0,124437.9,124437.9,124437.9,94224180.82999988,94224180.82999988,ACH,GBP
2025-02-04,Settlement from ClientLine,Processor Payout Batch,SET-20250131-ClientLine-Visa-GBP,,0,0,0,27873.97,27873.97,27873.97,94252054.79999988,94252054.79999988,ACH,GBP
2025-02-04,Settlement from GoCardless,Processor Payout Batch,SET-20250131-GoCardless-N/A-USD,,0,0,0,578679.5,578679.5,578679.5,94830734.29999988,94830734.29999988,ACH,USD
2025-02-04,Settlement from PayPal,Processor Payout Batch,SET-20250131-PayPal-N/A-USD,,0,0,0,552966.56,552966.56,552966.56,95383700.85999988,95383700.85999988,ACH,USD
2025-02-04,Settlement from ClientLine,Processor Payout Batch,SET-20250131-ClientLine-Visa-EUR,,0,0,0,52895.53,52895.53,52895.53,95436596.38999988,95436596.38999988,ACH,EUR
2025-02-04,Settlement from ClientLine,Processor Payout Batch,SET-20250131-ClientLine-Visa-AUD,,0,0,0,16907.69,16907.69,16907.69,95453504.07999988,95453504.07999988,ACH,AUD
2025-02-04,Settlement from ClientLine,Processor Payout Batch,SET-20250131-ClientLine-Mastercard-USD,,0,0,0,232467.49,232467.49,232467.49,95685971.56999987,95685971.56999987,ACH,USD
2025-02-04,Settlement from ClientLine,Processor Payout Batch,SET-20250131-ClientLine-Mastercard-GBP,,0,0,0,30616.89,30616.89,30616.89,95716588.45999987,95716588.45999987,ACH,GBP
2025-02-04,Settlement from ClientLine,Processor Payout Batch,SET-20250131-ClientLine-Mastercard-EUR,,0,0,0,54460.98,54460.98,54460.98,95771049.43999988,95771049.43999988,ACH,EUR
2025-02-04,Settlement from ClientLine,Processor Payout Batch,SET-20250131-ClientLine-Mastercard-CAD,,0,0,0,35351.16,35351.16,35351.16,95806400.59999987,95806400.59999987,ACH,CAD
2025-02-04,Settlement from ClientLine,Processor Payout Batch,SET-20250131-ClientLine-Mastercard-AUD,,0,0,0,13657.02,13657.02,13657.02,95820057.61999987,95820057.61999987,ACH,AUD
2025-02-04,Settlement from Amex,Processor Payout Batch,SET-20250131-Amex-Amex-USD,,0,0,0,214549.36,214549.36,214549.36,96034606.97999987,96034606.97999987,ACH,USD
2025-02-04,Settlement from Amex,Processor Payout Batch,SET-20250131-Amex-Amex-GBP,,0,0,0,31181.79,31181.79,31181.79,96065788.76999988,96065788.76999988,ACH,GBP
2025-02-04,Settlement from Amex,Processor Payout Batch,SET-20250131-Amex-Amex-EUR,,0,0,0,46717.47,46717.47,46717.47,96112506.23999988,96112506.23999988,ACH,EUR
2025-02-04,Settlement from Amex,Processor Payout Batch,SET-20250131-Amex-Amex-CAD,,0,0,0,14301.65,14301.65,14301.65,96126807.88999988,96126807.88999988,ACH,CAD
2025-02-04,Settlement from Amex,Processor Payout Batch,SET-20250131-Amex-Amex-AUD,,0,0,0,36367.38,36367.38,36367.38,96163175.26999988,96163175.26999988,ACH,AUD
2025-02-04,Settlement from ClientLine,Processor Payout Batch,SET-20250131-ClientLine-Visa-CAD,,0,0,0,17262.36,17262.36,17262.36,96180437.62999988,96180437.62999988,ACH,CAD
2025-02-05,Settlement from ClientLine,Processor Payout Batch,SET-20250203-ClientLine-Mastercard-GBP,,0,0,0,25741.02,25741.02,25741.02,96206178.64999987,96206178.64999987,ACH,GBP
2025-02-05,Settlement from ClientLine,Processor Payout Batch,SET-20250203-ClientLine-Mastercard-EUR,,0,0,0,56035.63,56035.63,56035.63,96262214.27999987,96262214.27999987,ACH,EUR
2025-02-05,Settlement from ClientLine,Processor Payout Batch,SET-20250203-ClientLine-Mastercard-CAD,,0,0,0,18024.78,18024.78,18024.78,96280239.05999987,96280239.05999987,ACH,CAD
2025-02-05,Settlement from ClientLine,Processor Payout Batch,SET-20250203-ClientLine-Mastercard-AUD,,0,0,0,35339.64,35339.64,35339.64,96315578.69999987,96315578.69999987,ACH,AUD
2025-02-05,Settlement from Amex,Processor Payout Batch,SET-20250203-Amex-Amex-AUD,,0,0,0,14366.7,14366.7,14366.7,96329945.39999987,96329945.39999987,ACH,AUD
2025-02-05,Settlement from Amex,Processor Payout Batch,SET-20250203-Amex-Amex-GBP,,0,0,0,16552.26,16552.26,16552.26,96346497.65999988,96346497.65999988,ACH,GBP
2025-02-05,Settlement from Amex,Processor Payout Batch,SET-20250203-Amex-Amex-EUR,,0,0,0,51890.92,51890.92,51890.92,96398388.57999988,96398388.57999988,ACH,EUR
2025-02-05,Settlement from Amex,Processor Payout Batch,SET-20250203-Amex-Amex-CAD,,0,0,0,12446.92,12446.92,12446.92,96410835.49999988,96410835.49999988,ACH,CAD
2025-02-05,Settlement from ClientLine,Processor Payout Batch,SET-20250203-ClientLine-Mastercard-USD,,0,0,0,189027.63,189027.63,189027.63,96599863.12999988,96599863.12999988,ACH,USD
2025-02-05,Settlement from Amex,Processor Payout Batch,SET-20250203-Amex-Amex-USD,,0,0,0,220934.97,220934.97,220934.97,96820798.09999987,96820798.09999987,ACH,USD
2025-02-05,Settlement from ClientLine,Processor Payout Batch,SET-20250203-ClientLine-Visa-AUD,,0,0,0,35789.05,35789.05,35789.05,96856587.14999987,96856587.14999987,ACH,AUD
2025-02-05,Settlement from GoCardless,Processor Payout Batch,SET-20250203-GoCardless-N/A-CAD,,0,0,0,56463.85,56463.85,56463.85,96913050.99999987,96913050.99999987,ACH,CAD
2025-02-05,Settlement from ClientLine,Processor Payout Batch,SET-20250203-ClientLine-Visa-EUR,,0,0,0,42978.62,42978.62,42978.62,96956029.61999987,96956029.61999987,ACH,EUR
2025-02-05,Settlement from ClientLine,Processor Payout Batch,SET-20250203-ClientLine-Visa-GBP,,0,0,0,24822.4,24822.4,24822.4,96980852.01999988,96980852.01999988,ACH,GBP
2025-02-05,Settlement from ClientLine,Processor Payout Batch,SET-20250203-ClientLine-Visa-USD,,0,0,0,242781.63,242781.63,242781.63,97223633.64999987,97223633.64999987,ACH,USD
2025-02-05,Settlement from GoCardless,Processor Payout Batch,SET-20250203-GoCardless-N/A-AUD,,0,0,0,71894.93,71894.93,71894.93,97295528.57999988,97295528.57999988,ACH,AUD
2025-02-05,Settlement from GoCardless,Processor Payout Batch,SET-20250203-GoCardless-N/A-EUR,,0,0,0,115647.29,115647.29,115647.29,97411175.86999989,97411175.86999989,ACH,EUR
2025-02-05,Settlement from GoCardless,Processor Payout Batch,SET-20250203-GoCardless-N/A-GBP,,0,0,0,125649.32,125649.32,125649.32,97536825.18999988,97536825.18999988,ACH,GBP
2025-02-05,Settlement from GoCardless,Processor Payout Batch,SET-20250203-GoCardless-N/A-USD,,0,0,0,659720.12,659720.12,659720.12,98196545.30999988,98196545.30999988,ACH,USD
2025-02-05,Settlement from PayPal,Processor Payout Batch,SET-20250203-PayPal-N/A-AUD,,0,0,0,75864.12,75864.12,75864.12,98272409.42999989,98272409.42999989,ACH,AUD
2025-02-05,Settlement from PayPal,Processor Payout Batch,SET-20250203-PayPal-N/A-CAD,,0,0,0,58439.68,58439.68,58439.68,98330849.1099999,98330849.1099999,ACH,CAD
2025-02-05,Settlement from PayPal,Processor Payout Batch,SET-20250203-PayPal-N/A-EUR,,0,0,0,144984.79,144984.79,144984.79,98475833.8999999,98475833.8999999,ACH,EUR
2025-02-05,Settlement from ClientLine,Processor Payout Batch,SET-20250203-ClientLine-Visa-CAD,,0,0,0,18780.52,18780.52,18780.52,98494614.4199999,98494614.4199999,ACH,CAD
2025-02-05,Settlement from PayPal,Processor Payout Batch,SET-20250201-PayPal-N/A-USD,,0,0,0,659387.41,659387.41,659387.41,99154001.8299999,99154001.8299999,ACH,USD
2025-02-05,Settlement from PayPal,Processor Payout Batch,SET-20250203-PayPal-N/A-USD,,0,0,0,575215.62,575215.62,575215.62,99729217.4499999,99729217.4499999,ACH,USD
2025-02-05,Settlement from ClientLine,Processor Payout Batch,SET-20250201-ClientLine-Mastercard-USD,,0,0,0,168843.4,168843.4,168843.4,99898060.8499999,99898060.8499999,ACH,USD
2025-02-05,Settlement from PayPal,Processor Payout Batch,SET-20250201-PayPal-N/A-AUD,,0,0,0,78792.71,78792.71,78792.71,99976853.5599999,99976853.5599999,ACH,AUD
2025-02-05,Settlement from GoCardless,Processor Payout Batch,SET-20250201-GoCardless-N/A-USD,,0,0,0,630247.95,630247.95,630247.95,100607101.5099999,100607101.5099999,ACH,USD
2025-02-05,Settlement from GoCardless,Processor Payout Batch,SET-20250201-GoCardless-N/A-GBP,,0,0,0,135954.32,135954.32,135954.32,100743055.8299999,100743055.8299999,ACH,GBP
2025-02-05,Settlement from GoCardless,Processor Payout Batch,SET-20250201-GoCardless-N/A-EUR,,0,0,0,149737.73,149737.73,149737.73,100892793.5599999,100892793.5599999,ACH,EUR
2025-02-05,Settlement from GoCardless,Processor Payout Batch,SET-20250201-GoCardless-N/A-CAD,,0,0,0,71888.68,71888.68,71888.68,100964682.2399999,100964682.2399999,ACH,CAD
2025-02-05,Settlement from GoCardless,Processor Payout Batch,SET-20250201-GoCardless-N/A-AUD,,0,0,0,109540.61,109540.61,109540.61,101074222.8499999,101074222.8499999,ACH,AUD
2025-02-05,Settlement from ClientLine,Processor Payout Batch,SET-20250201-ClientLine-Visa-USD,,0,0,0,176466.75,176466.75,176466.75,101250689.5999999,101250689.5999999,ACH,USD
2025-02-05,Settlement from ClientLine,Processor Payout Batch,SET-20250201-ClientLine-Visa-GBP,,0,0,0,55563.73,55563.73,55563.73,101306253.32999991,101306253.32999991,ACH,GBP
2025-02-05,Settlement from ClientLine,Processor Payout Batch,SET-20250201-ClientLine-Visa-EUR,,0,0,0,42554.39,42554.39,42554.39,101348807.71999991,101348807.71999991,ACH,EUR
2025-02-05,Settlement from ClientLine,Processor Payout Batch,SET-20250201-ClientLine-Visa-CAD,,0,0,0,14323.0,14323.0,14323.0,101363130.71999991,101363130.71999991,ACH,CAD
2025-02-05,Settlement from ClientLine,Processor Payout Batch,SET-20250201-ClientLine-Visa-AUD,,0,0,0,31706.01,31706.01,31706.01,101394836.72999991,101394836.72999991,ACH,AUD
2025-02-05,Settlement from PayPal,Processor Payout Batch,SET-20250201-PayPal-N/A-CAD,,0,0,0,88965.32,88965.32,88965.32,101483802.04999991,101483802.04999991,ACH,CAD
2025-02-05,Settlement from ClientLine,Processor Payout Batch,SET-20250201-ClientLine-Mastercard-GBP,,0,0,0,34864.98,34864.98,34864.98,101518667.02999991,101518667.02999991,ACH,GBP
2025-02-05,Settlement from ClientLine,Processor Payout Batch,SET-20250201-ClientLine-Mastercard-EUR,,0,0,0,55915.35,55915.35,55915.35,101574582.3799999,101574582.3799999,ACH,EUR
2025-02-05,Settlement from ClientLine,Processor Payout Batch,SET-20250201-ClientLine-Mastercard-CAD,,0,0,0,17041.15,17041.15,17041.15,101591623.52999991,101591623.52999991,ACH,CAD
2025-02-05,Settlement from ClientLine,Processor Payout Batch,SET-20250201-ClientLine-Mastercard-AUD,,0,0,0,23655.2,23655.2,23655.2,101615278.72999991,101615278.72999991,ACH,AUD
2025-02-05,Settlement from Amex,Processor Payout Batch,SET-20250201-Amex-Amex-USD,,0,0,0,205932.99,205932.99,205932.99,101821211.71999991,101821211.71999991,ACH,USD
2025-02-05,Settlement from PayPal,Processor Payout Batch,SET-20250201-PayPal-N/A-EUR,,0,0,0,156883.52,156883.52,156883.52,101978095.2399999,101978095.2399999,ACH,EUR
2025-02-05,Settlement from Amex,Processor Payout Batch,SET-20250201-Amex-Amex-GBP,,0,0,0,38572.42,38572.42,38572.42,102016667.6599999,102016667.6599999,ACH,GBP
2025-02-05,Settlement from Amex,Processor Payout Batch,SET-20250201-Amex-Amex-EUR,,0,0,0,65446.95,65446.95,65446.95,102082114.60999991,102082114.60999991,ACH,EUR
2025-02-05,Settlement from Amex,Processor Payout Batch,SET-20250201-Amex-Amex-CAD,,0,0,0,13855.6,13855.6,13855.6,102095970.2099999,102095970.2099999,ACH,CAD
2025-02-05,Settlement from Amex,Processor Payout Batch,SET-20250201-Amex-Amex-AUD,,0,0,0,29569.11,29569.11,29569.11,102125539.3199999,102125539.3199999,ACH,AUD
2025-02-05,Settlement from PayPal,Processor Payout Batch,SET-20250203-PayPal-N/A-GBP,,0,0,0,106386.59,106386.59,106386.59,102231925.9099999,102231925.9099999,ACH,GBP
2025-02-05,Settlement from PayPal,Processor Payout Batch,SET-20250201-PayPal-N/A-GBP,,0,0,0,130308.84,130308.84,130308.84,102362234.74999991,102362234.74999991,ACH,GBP
2025-02-06,Settlement from PayPal,Processor Payout Batch,SET-20250204-PayPal-N/A-GBP,,0,0,0,120925.18,120925.18,120925.18,102483159.92999992,102483159.92999992,ACH,GBP
2025-02-06,Settlement from Amex,Processor Payout Batch,SET-20250204-Amex-Amex-AUD,,0,0,0,27210.79,27210.79,27210.79,102510370.71999992,102510370.71999992,ACH,AUD
2025-02-06,Settlement from Amex,Processor Payout Batch,SET-20250204-Amex-Amex-EUR,,0,0,0,39130.12,39130.12,39130.12,102549500.83999993,102549500.83999993,ACH,EUR
2025-02-06,Settlement from PayPal,Processor Payout Batch,SET-20250204-PayPal-N/A-EUR,,0,0,0,131473.56,131473.56,131473.56,102680974.39999993,102680974.39999993,ACH,EUR
2025-02-06,Settlement from PayPal,Processor Payout Batch,SET-20250204-PayPal-N/A-CAD,,0,0,0,98282.98,98282.98,98282.98,102779257.37999994,102779257.37999994,ACH,CAD
2025-02-06,Settlement from PayPal,Processor Payout Batch,SET-20250204-PayPal-N/A-AUD,,0,0,0,86290.16,86290.16,86290.16,102865547.53999993,102865547.53999993,ACH,AUD
2025-02-06,Settlement from GoCardless,Processor Payout Batch,SET-20250204-GoCardless-N/A-USD,,0,0,0,633639.6,633639.6,633639.6,103499187.13999993,103499187.13999993,ACH,USD
2025-02-06,Settlement from GoCardless,Processor Payout Batch,SET-20250204-GoCardless-N/A-GBP,,0,0,0,122540.37,122540.37,122540.37,103621727.50999993,103621727.50999993,ACH,GBP
2025-02-06,Settlement from GoCardless,Processor Payout Batch,SET-20250204-GoCardless-N/A-CAD,,0,0,0,63658.51,63658.51,63658.51,103685386.01999994,103685386.01999994,ACH,CAD
2025-02-06,Settlement from GoCardless,Processor Payout Batch,SET-20250204-GoCardless-N/A-AUD,,0,0,0,98466.41,98466.41,98466.41,103783852.42999993,103783852.42999993,ACH,AUD
2025-02-06,Settlement from ClientLine,Processor Payout Batch,SET-20250204-ClientLine-Visa-USD,,0,0,0,240358.55,240358.55,240358.55,104024210.97999993,104024210.97999993,ACH,USD
2025-02-06,Settlement from ClientLine,Processor Payout Batch,SET-20250204-ClientLine-Visa-GBP,,0,0,0,21967.63,21967.63,21967.63,104046178.60999992,104046178.60999992,ACH,GBP
2025-02-06,Settlement from Amex,Processor Payout Batch,SET-20250204-Amex-Amex-CAD,,0,0,0,43232.82,43232.82,43232.82,104089411.42999992,104089411.42999992,ACH,CAD
2025-02-06,Settlement from ClientLine,Processor Payout Batch,SET-20250204-ClientLine-Visa-EUR,,0,0,0,52684.19,52684.19,52684.19,104142095.61999992,104142095.61999992,ACH,EUR
2025-02-06,Settlement from ClientLine,Processor Payout Batch,SET-20250204-ClientLine-Visa-CAD,,0,0,0,57420.2,57420.2,57420.2,104199515.81999992,104199515.81999992,ACH,CAD
2025-02-06,Settlement from ClientLine,Processor Payout Batch,SET-20250204-ClientLine-Visa-AUD,,0,0,0,15256.24,15256.24,15256.24,104214772.05999991,104214772.05999991,ACH,AUD
2025-02-06,Settlement from ClientLine,Processor Payout Batch,SET-20250204-ClientLine-Mastercard-USD,,0,0,0,209599.11,209599.11,209599.11,104424371.16999991,104424371.16999991,ACH,USD
2025-02-06,Settlement from ClientLine,Processor Payout Batch,SET-20250204-ClientLine-Mastercard-GBP,,0,0,0,45687.53,45687.53,45687.53,104470058.69999991,104470058.69999991,ACH,GBP
2025-02-06,Settlement from ClientLine,Processor Payout Batch,SET-20250204-ClientLine-Mastercard-EUR,,0,0,0,40306.57,40306.57,40306.57,104510365.2699999,104510365.2699999,ACH,EUR
2025-02-06,Settlement from ClientLine,Processor Payout Batch,SET-20250204-ClientLine-Mastercard-CAD,,0,0,0,43862.53,43862.53,43862.53,104554227.79999991,104554227.79999991,ACH,CAD
2025-02-06,Settlement from ClientLine,Processor Payout Batch,SET-20250204-ClientLine-Mastercard-AUD,,0,0,0,45352.17,45352.17,45352.17,104599579.96999991,104599579.96999991,ACH,AUD
2025-02-06,Settlement from Amex,Processor Payout Batch,SET-20250204-Amex-Amex-USD,,0,0,0,194103.04,194103.04,194103.04,104793683.00999992,104793683.00999992,ACH,USD
2025-02-06,Settlement from Amex,Processor Payout Batch,SET-20250204-Amex-Amex-GBP,,0,0,0,39819.01,39819.01,39819.01,104833502.01999992,104833502.01999992,ACH,GBP
2025-02-06,Settlement from PayPal,Processor Payout Batch,SET-20250204-PayPal-N/A-USD,,0,0,0,642117.88,642117.88,642117.88,105475619.89999992,105475619.89999992,ACH,USD
2025-02-06,Settlement from GoCardless,Processor Payout Batch,SET-20250204-GoCardless-N/A-EUR,,0,0,0,133111.15,133111.15,133111.15,105608731.04999992,105608731.04999992,ACH,EUR
2025-02-06,Settlement from ClientLine,Processor Payout Batch,SET-20250202-ClientLine-Visa-EUR,,0,0,0,71189.27,71189.27,71189.27,105679920.31999992,105679920.31999992,ACH,EUR
2025-02-06,Settlement from PayPal,Processor Payout Batch,SET-20250202-PayPal-N/A-GBP,,0,0,0,130355.03,130355.03,130355.03,105810275.34999992,105810275.34999992,ACH,GBP
2025-02-06,Settlement from PayPal,Processor Payout Batch,SET-20250202-PayPal-N/A-USD,,0,0,0,652986.91,652986.91,652986.91,106463262.25999992,106463262.25999992,ACH,USD
2025-02-06,Settlement from Amex,Processor Payout Batch,SET-20250202-Amex-Amex-AUD,,0,0,0,17295.2,17295.2,17295.2,106480557.45999992,106480557.45999992,ACH,AUD
2025-02-06,Settlement from Amex,Processor Payout Batch,SET-20250202-Amex-Amex-CAD,,0,0,0,32435.2,32435.2,32435.2,106512992.65999992,106512992.65999992,ACH,CAD
2025-02-06,Settlement from Amex,Processor Payout Batch,SET-20250202-Amex-Amex-EUR,,0,0,0,56868.31,56868.31,56868.31,106569860.96999992,106569860.96999992,ACH,EUR
2025-02-06,Settlement from Amex,Processor Payout Batch,SET-20250202-Amex-Amex-GBP,,0,0,0,43792.42,43792.42,43792.42,106613653.38999993,106613653.38999993,ACH,GBP
2025-02-06,Settlement from Amex,Processor Payout Batch,SET-20250202-Amex-Amex-USD,,0,0,0,202549.85,202549.85,202549.85,106816203.23999992,106816203.23999992,ACH,USD
2025-02-06,Settlement from ClientLine,Processor Payout Batch,SET-20250202-ClientLine-Mastercard-CAD,,0,0,0,23190.23,23190.23,23190.23,106839393.46999992,106839393.46999992,ACH,CAD
2025-02-06,Settlement from ClientLine,Processor Payout Batch,SET-20250202-ClientLine-Mastercard-EUR,,0,0,0,50916.85,50916.85,50916.85,106890310.31999992,106890310.31999992,ACH,EUR
2025-02-06,Settlement from ClientLine,Processor Payout Batch,SET-20250202-ClientLine-Mastercard-GBP,,0,0,0,44168.51,44168.51,44168.51,106934478.82999992,106934478.82999992,ACH,GBP
2025-02-06,Settlement from ClientLine,Processor Payout Batch,SET-20250202-ClientLine-Mastercard-USD,,0,0,0,203775.03,203775.03,203775.03,107138253.85999992,107138253.85999992,ACH,USD
2025-02-06,Settlement from ClientLine,Processor Payout Batch,SET-20250202-ClientLine-Visa-AUD,,0,0,0,36226.37,36226.37,36226.37,107174480.22999993,107174480.22999993,ACH,AUD
2025-02-06,Settlement from ClientLine,Processor Payout Batch,SET-20250202-ClientLine-Mastercard-AUD,,0,0,0,32380.72,32380.72,32380.72,107206860.94999993,107206860.94999993,ACH,AUD
2025-02-06,Settlement from ClientLine,Processor Payout Batch,SET-20250202-ClientLine-Visa-GBP,,0,0,0,49314.04,49314.04,49314.04,107256174.98999994,107256174.98999994,ACH,GBP
2025-02-06,Settlement from ClientLine,Processor Payout Batch,SET-20250202-ClientLine-Visa-USD,,0,0,0,196619.17,196619.17,196619.17,107452794.15999994,107452794.15999994,ACH,USD
2025-02-06,Settlement from GoCardless,Processor Payout Batch,SET-20250202-GoCardless-N/A-AUD,,0,0,0,114263.42,114263.42,114263.42,107567057.57999994,107567057.57999994,ACH,AUD
2025-02-06,Settlement from GoCardless,Processor Payout Batch,SET-20250202-GoCardless-N/A-CAD,,0,0,0,74582.2,74582.2,74582.2,107641639.77999994,107641639.77999994,ACH,CAD
2025-02-06,Settlement from GoCardless,Processor Payout Batch,SET-20250202-GoCardless-N/A-EUR,,0,0,0,135393.75,135393.75,135393.75,107777033.52999994,107777033.52999994,ACH,EUR
2025-02-06,Settlement from GoCardless,Processor Payout Batch,SET-20250202-GoCardless-N/A-GBP,,0,0,0,115079.82,115079.82,115079.82,107892113.34999993,107892113.34999993,ACH,GBP
2025-02-06,Settlement from GoCardless,Processor Payout Batch,SET-20250202-GoCardless-N/A-USD,,0,0,0,701471.09,701471.09,701471.09,108593584.43999994,108593584.43999994,ACH,USD
2025-02-06,Settlement from PayPal,Processor Payout Batch,SET-20250202-PayPal-N/A-AUD,,0,0,0,77310.83,77310.83,77310.83,108670895.26999994,108670895.26999994,ACH,AUD
2025-02-06,Settlement from PayPal,Processor Payout Batch,SET-20250202-PayPal-N/A-CAD,,0,0,0,78293.57,78293.57,78293.57,108749188.83999993,108749188.83999993,ACH,CAD
2025-02-06,Settlement from PayPal,Processor Payout Batch,SET-20250202-PayPal-N/A-EUR,,0,0,0,144056.3,144056.3,144056.3,108893245.13999993,108893245.13999993,ACH,EUR
2025-02-06,Settlement from ClientLine,Processor Payout Batch,SET-20250202-ClientLine-Visa-CAD,,0,0,0,20805.67,20805.67,20805.67,108914050.80999993,108914050.80999993,ACH,CAD
2025-02-07,Settlement from GoCardless,Processor Payout Batch,SET-20250205-GoCardless-N/A-AUD,,0,0,0,58136.49,58136.49,58136.49,108972187.29999992,108972187.29999992,ACH,AUD
2025-02-07,Settlement from GoCardless,Processor Payout Batch,SET-20250205-GoCardless-N/A-CAD,,0,0,0,66379.13,66379.13,66379.13,109038566.42999992,109038566.42999992,ACH,CAD
2025-02-07,Settlement from GoCardless,Processor Payout Batch,SET-20250205-GoCardless-N/A-EUR,,0,0,0,157405.56,157405.56,157405.56,109195971.98999992,109195971.98999992,ACH,EUR
2025-02-07,Settlement from GoCardless,Processor Payout Batch,SET-20250205-GoCardless-N/A-GBP,,0,0,0,101563.52,101563.52,101563.52,109297535.50999992,109297535.50999992,ACH,GBP
2025-02-07,Settlement from GoCardless,Processor Payout Batch,SET-20250205-GoCardless-N/A-USD,,0,0,0,566500.52,566500.52,566500.52,109864036.02999991,109864036.02999991,ACH,USD
2025-02-07,Settlement from PayPal,Processor Payout Batch,SET-20250205-PayPal-N/A-USD,,0,0,0,612256.6,612256.6,612256.6,110476292.6299999,110476292.6299999,ACH,USD
2025-02-07,Settlement from PayPal,Processor Payout Batch,SET-20250205-PayPal-N/A-CAD,,0,0,0,69270.78,69270.78,69270.78,110545563.4099999,110545563.4099999,ACH,CAD
2025-02-07,Settlement from PayPal,Processor Payout Batch,SET-20250205-PayPal-N/A-EUR,,0,0,0,133917.05,133917.05,133917.05,110679480.4599999,110679480.4599999,ACH,EUR
2025-02-07,Settlement from PayPal,Processor Payout Batch,SET-20250205-PayPal-N/A-GBP,,0,0,0,72455.54,72455.54,72455.54,110751935.99999991,110751935.99999991,ACH,GBP
2025-02-07,Settlement from ClientLine,Processor Payout Batch,SET-20250205-ClientLine-Visa-USD,,0,0,0,161113.02,161113.02,161113.02,110913049.0199999,110913049.0199999,ACH,USD
2025-02-07,Settlement from PayPal,Processor Payout Batch,SET-20250205-PayPal-N/A-AUD,,0,0,0,67288.39,67288.39,67288.39,110980337.4099999,110980337.4099999,ACH,AUD
2025-02-07,Settlement from ClientLine,Processor Payout Batch,SET-20250205-ClientLine-Visa-GBP,,0,0,0,36519.01,36519.01,36519.01,111016856.41999991,111016856.41999991,ACH,GBP
2025-02-07,Settlement from ClientLine,Processor Payout Batch,SET-20250205-ClientLine-Mastercard-CAD,,0,0,0,44354.46,44354.46,44354.46,111061210.8799999,111061210.8799999,ACH,CAD
2025-02-07,Settlement from ClientLine,Processor Payout Batch,SET-20250205-ClientLine-Visa-CAD,,0,0,0,22320.34,22320.34,22320.34,111083531.21999991,111083531.21999991,ACH,CAD
2025-02-07,Settlement from ClientLine,Processor Payout Batch,SET-20250205-ClientLine-Visa-EUR,,0,0,0,50980.18,50980.18,50980.18,111134511.39999992,111134511.39999992,ACH,EUR
2025-02-07,Settlement from Amex,Processor Payout Batch,SET-20250205-Amex-Amex-CAD,,0,0,0,48015.52,48015.52,48015.52,111182526.91999991,111182526.91999991,ACH,CAD
2025-02-07,Settlement from Amex,Processor Payout Batch,SET-20250205-Amex-Amex-EUR,,0,0,0,59910.57,59910.57,59910.57,111242437.4899999,111242437.4899999,ACH,EUR
2025-02-07,Settlement from Amex,Processor Payout Batch,SET-20250205-Amex-Amex-GBP,,0,0,0,22934.05,22934.05,22934.05,111265371.5399999,111265371.5399999,ACH,GBP
2025-02-07,Settlement from Amex,Processor Payout Batch,SET-20250205-Amex-Amex-USD,,0,0,0,199639.49,199639.49,199639.49,111465011.0299999,111465011.0299999,ACH,USD
2025-02-07,Settlement from Amex,Processor Payout Batch,SET-20250205-Amex-Amex-AUD,,0,0,0,34996.44,34996.44,34996.44,111500007.4699999,111500007.4699999,ACH,AUD
2025-02-07,Settlement from ClientLine,Processor Payout Batch,SET-20250205-ClientLine-Mastercard-EUR,,0,0,0,68236.56,68236.56,68236.56,111568244.0299999,111568244.0299999,ACH,EUR
2025-02-07,Settlement from ClientLine,Processor Payout Batch,SET-20250205-ClientLine-Mastercard-GBP,,0,0,0,37913.47,37913.47,37913.47,111606157.4999999,111606157.4999999,ACH,GBP
2025-02-07,Settlement from ClientLine,Processor Payout Batch,SET-20250205-ClientLine-Mastercard-USD,,0,0,0,167736.03,167736.03,167736.03,111773893.5299999,111773893.5299999,ACH,USD
2025-02-07,Settlement from ClientLine,Processor Payout Batch,SET-20250205-ClientLine-Visa-AUD,,0,0,0,35264.4,35264.4,35264.4,111809157.9299999,111809157.9299999,ACH,AUD
2025-02-07,Settlement from ClientLine,Processor Payout Batch,SET-20250205-ClientLine-Mastercard-AUD,,0,0,0,38901.24,38901.24,38901.24,111848059.1699999,111848059.1699999,ACH,AUD
2025-02-10,Settlement from ClientLine,Processor Payout Batch,SET-20250206-ClientLine-Visa-USD,,0,0,0,210406.28,210406.28,210406.28,112058465.4499999,112058465.4499999,ACH,USD
2025-02-10,Settlement from GoCardless,Processor Payout Batch,SET-20250206-GoCardless-N/A-AUD,,0,0,0,87619.44,87619.44,87619.44,112146084.8899999,112146084.8899999,ACH,AUD
2025-02-10,Settlement from GoCardless,Processor Payout Batch,SET-20250206-GoCardless-N/A-CAD,,0,0,0,87033.18,87033.18,87033.18,112233118.0699999,112233118.0699999,ACH,CAD
2025-02-10,Settlement from GoCardless,Processor Payout Batch,SET-20250206-GoCardless-N/A-EUR,,0,0,0,135521.58,135521.58,135521.58,112368639.6499999,112368639.6499999,ACH,EUR
2025-02-10,Settlement from GoCardless,Processor Payout Batch,SET-20250206-GoCardless-N/A-GBP,,0,0,0,85987.67,85987.67,85987.67,112454627.3199999,112454627.3199999,ACH,GBP
2025-02-10,Settlement from PayPal,Processor Payout Batch,SET-20250206-PayPal-N/A-CAD,,0,0,0,72032.15,72032.15,72032.15,112526659.46999991,112526659.46999991,ACH,CAD
2025-02-10,Settlement from PayPal,Processor Payout Batch,SET-20250206-PayPal-N/A-AUD,,0,0,0,81938.54,81938.54,81938.54,112608598.00999992,112608598.00999992,ACH,AUD
2025-02-10,Settlement from PayPal,Processor Payout Batch,SET-20250206-PayPal-N/A-EUR,,0,0,0,148012.23,148012.23,148012.23,112756610.23999992,112756610.23999992,ACH,EUR
2025-02-10,Settlement from PayPal,Processor Payout Batch,SET-20250206-PayPal-N/A-GBP,,0,0,0,72987.21,72987.21,72987.21,112829597.44999991,112829597.44999991,ACH,GBP
2025-02-10,Settlement from PayPal,Processor Payout Batch,SET-20250206-PayPal-N/A-USD,,0,0,0,609774.5,609774.5,609774.5,113439371.94999991,113439371.94999991,ACH,USD
2025-02-10,Settlement from GoCardless,Processor Payout Batch,SET-20250206-GoCardless-N/A-USD,,0,0,0,536487.92,536487.92,536487.92,113975859.86999992,113975859.86999992,ACH,USD
2025-02-10,Settlement from ClientLine,Processor Payout Batch,SET-20250206-ClientLine-Visa-GBP,,0,0,0,28285.23,28285.23,28285.23,114004145.09999992,114004145.09999992,ACH,GBP
2025-02-10,Settlement from ClientLine,Processor Payout Batch,SET-20250206-ClientLine-Visa-EUR,,0,0,0,42899.14,42899.14,42899.14,114047044.23999992,114047044.23999992,ACH,EUR
2025-02-10,Settlement from ClientLine,Processor Payout Batch,SET-20250206-ClientLine-Visa-CAD,,0,0,0,13930.02,13930.02,13930.02,114060974.25999992,114060974.25999992,ACH,CAD
2025-02-10,Settlement from Amex,Processor Payout Batch,SET-20250206-Amex-Amex-CAD,,0,0,0,34772.23,34772.23,34772.23,114095746.48999992,114095746.48999992,ACH,CAD
2025-02-10,Settlement from Amex,Processor Payout Batch,SET-20250206-Amex-Amex-EUR,,0,0,0,72497.7,72497.7,72497.7,114168244.18999992,114168244.18999992,ACH,EUR
2025-02-10,Settlement from Amex,Processor Payout Batch,SET-20250206-Amex-Amex-GBP,,0,0,0,41512.65,41512.65,41512.65,114209756.83999993,114209756.83999993,ACH,GBP
2025-02-10,Settlement from Amex,Processor Payout Batch,SET-20250206-Amex-Amex-USD,,0,0,0,210498.07,210498.07,210498.07,114420254.90999992,114420254.90999992,ACH,USD
2025-02-10,Settlement from ClientLine,Processor Payout Batch,SET-20250206-ClientLine-Mastercard-AUD,,0,0,0,12938.11,12938.11,12938.11,114433193.01999992,114433193.01999992,ACH,AUD
2025-02-10,Settlement from Amex,Processor Payout Batch,SET-20250206-Amex-Amex-AUD,,0,0,0,37421.54,37421.54,37421.54,114470614.55999993,114470614.55999993,ACH,AUD
2025-02-10,Settlement from ClientLine,Processor Payout Batch,SET-20250206-ClientLine-Mastercard-EUR,,0,0,0,54980.9,54980.9,54980.9,114525595.45999993,114525595.45999993,ACH,EUR
2025-02-10,Settlement from ClientLine,Processor Payout Batch,SET-20250206-ClientLine-Mastercard-GBP,,0,0,0,36564.74,36564.74,36564.74,114562160.19999993,114562160.19999993,ACH,GBP
2025-02-10,Settlement from ClientLine,Processor Payout Batch,SET-20250206-ClientLine-Mastercard-USD,,0,0,0,209493.24,209493.24,209493.24,114771653.43999992,114771653.43999992,ACH,USD
2025-02-10,Settlement from ClientLine,Processor Payout Batch,SET-20250206-ClientLine-Visa-AUD,,0,0,0,23299.12,23299.12,23299.12,114794952.55999993,114794952.55999993,ACH,AUD
2025-02-10,Settlement from ClientLine,Processor Payout Batch,SET-20250206-ClientLine-Mastercard-CAD,,0,0,0,15284.17,15284.17,15284.17,114810236.72999993,114810236.72999993,ACH,CAD
2025-02-11,Settlement from ClientLine,Processor Payout Batch,SET-20250207-ClientLine-Visa-USD,,0,0,0,211569.95,211569.95,211569.95,115021806.67999993,115021806.67999993,ACH,USD
2025-02-11,Settlement from GoCardless,Processor Payout Batch,SET-20250207-GoCardless-N/A-AUD,,0,0,0,89870.35,89870.35,89870.35,115111677.02999993,115111677.02999993,ACH,AUD
2025-02-11,Settlement from GoCardless,Processor Payout Batch,SET-20250207-GoCardless-N/A-CAD,,0,0,0,75200.43,75200.43,75200.43,115186877.45999993,115186877.45999993,ACH,CAD
2025-02-11,Settlement from GoCardless,Processor Payout Batch,SET-20250207-GoCardless-N/A-EUR,,0,0,0,156619.23,156619.23,156619.23,115343496.68999994,115343496.68999994,ACH,EUR
2025-02-11,Settlement from GoCardless,Processor Payout Batch,SET-20250207-GoCardless-N/A-USD,,0,0,0,637041.59,637041.59,637041.59,115980538.27999994,115980538.27999994,ACH,USD
2025-02-11,Settlement from PayPal,Processor Payout Batch,SET-20250207-PayPal-N/A-CAD,,0,0,0,87460.31,87460.31,87460.31,116067998.58999994,116067998.58999994,ACH,CAD
2025-02-11,Settlement from PayPal,Processor Payout Batch,SET-20250207-PayPal-N/A-EUR,,0,0,0,142650.56,142650.56,142650.56,116210649.14999995,116210649.14999995,ACH,EUR
2025-02-11,Settlement from PayPal,Processor Payout Batch,SET-20250207-PayPal-N/A-GBP,,0,0,0,111449.48,111449.48,111449.48,116322098.62999995,116322098.62999995,ACH,GBP
2025-02-11,Settlement from PayPal,Processor Payout Batch,SET-20250207-PayPal-N/A-USD,,0,0,0,584960.78,584960.78,584960.78,116907059.40999995,116907059.40999995,ACH,USD
2025-02-11,Settlement from ClientLine,Processor Payout Batch,SET-20250207-ClientLine-Visa-GBP,,0,0,0,13296.77,13296.77,13296.77,116920356.17999995,116920356.17999995,ACH,GBP
2025-02-11,Settlement from PayPal,Processor Payout Batch,SET-20250207-PayPal-N/A-AUD,,0,0,0,97543.26,97543.26,97543.26,117017899.43999995,117017899.43999995,ACH,AUD
2025-02-11,Settlement from ClientLine,Processor Payout Batch,SET-20250207-ClientLine-Visa-EUR,,0,0,0,89005.92,89005.92,89005.92,117106905.35999995,117106905.35999995,ACH,EUR
2025-02-11,Settlement from GoCardless,Processor Payout Batch,SET-20250207-GoCardless-N/A-GBP,,0,0,0,96104.64,96104.64,96104.64,117203009.99999996,117203009.99999996,ACH,GBP
2025-02-11,Settlement from ClientLine,Processor Payout Batch,SET-20250207-ClientLine-Visa-AUD,,0,0,0,26864.14,26864.14,26864.14,117229874.13999996,117229874.13999996,ACH,AUD
2025-02-11,Settlement from ClientLine,Processor Payout Batch,SET-20250207-ClientLine-Visa-CAD,,0,0,0,21812.85,21812.85,21812.85,117251686.98999995,117251686.98999995,ACH,CAD
2025-02-11,Settlement from Amex,Processor Payout Batch,SET-20250207-Amex-Amex-CAD,,0,0,0,9898.99,9898.99,9898.99,117261585.97999994,117261585.97999994,ACH,CAD
2025-02-11,Settlement from Amex,Processor Payout Batch,SET-20250207-Amex-Amex-EUR,,0,0,0,67594.12,67594.12,67594.12,117329180.09999995,117329180.09999995,ACH,EUR
2025-02-11,Settlement from Amex,Processor Payout Batch,SET-20250207-Amex-Amex-GBP,,0,0,0,24958.62,24958.62,24958.62,117354138.71999995,117354138.71999995,ACH,GBP
2025-02-11,Settlement from Amex,Processor Payout Batch,SET-20250207-Amex-Amex-USD,,0,0,0,210390.04,210390.04,210390.04,117564528.75999996,117564528.75999996,ACH,USD
2025-02-11,Settlement from Amex,Processor Payout Batch,SET-20250207-Amex-Amex-AUD,,0,0,0,45806.07,45806.07,45806.07,117610334.82999995,117610334.82999995,ACH,AUD
2025-02-11,Settlement from ClientLine,Processor Payout Batch,SET-20250207-ClientLine-Mastercard-CAD,,0,0,0,21512.88,21512.88,21512.88,117631847.70999995,117631847.70999995,ACH,CAD
2025-02-11,Settlement from ClientLine,Processor Payout Batch,SET-20250207-ClientLine-Mastercard-EUR,,0,0,0,33210.53,33210.53,33210.53,117665058.23999995,117665058.23999995,ACH,EUR
2025-02-11,Settlement from ClientLine,Processor Payout Batch,SET-20250207-ClientLine-Mastercard-GBP,,0,0,0,23019.21,23019.21,23019.21,117688077.44999994,117688077.44999994,ACH,GBP
2025-02-11,Settlement from ClientLine,Processor Payout Batch,SET-20250207-ClientLine-Mastercard-USD,,0,0,0,232731.4,232731.4,232731.4,117920808.84999995,117920808.84999995,ACH,USD
2025-02-11,Settlement from ClientLine,Processor Payout Batch,SET-20250207-ClientLine-Mastercard-AUD,,0,0,0,30677.69,30677.69,30677.69,117951486.53999995,117951486.53999995,ACH,AUD
2025-02-12,Settlement from Amex,Processor Payout Batch,SET-20250210-Amex-Amex-EUR,,0,0,0,52221.69,52221.69,52221.69,118003708.22999994,118003708.22999994,ACH,EUR
2025-02-12,Settlement from ClientLine,Processor Payout Batch,SET-20250210-ClientLine-Visa-AUD,,0,0,0,36821.91,36821.91,36821.91,118040530.13999994,118040530.13999994,ACH,AUD
2025-02-12,Settlement from Amex,Processor Payout Batch,SET-20250210-Amex-Amex-GBP,,0,0,0,42444.36,42444.36,42444.36,118082974.49999994,118082974.49999994,ACH,GBP
2025-02-12,Settlement from Amex,Processor Payout Batch,SET-20250210-Amex-Amex-USD,,0,0,0,188276.08,188276.08,188276.08,118271250.57999994,118271250.57999994,ACH,USD
2025-02-12,Settlement from ClientLine,Processor Payout Batch,SET-20250210-ClientLine-Mastercard-AUD,,0,0,0,12389.36,12389.36,12389.36,118283639.93999994,118283639.93999994,ACH,AUD
2025-02-12,Settlement from PayPal,Processor Payout Batch,SET-20250210-PayPal-N/A-USD,,0,0,0,575763.94,575763.94,575763.94,118859403.87999994,118859403.87999994,ACH,USD
2025-02-12,Settlement from ClientLine,Processor Payout Batch,SET-20250210-ClientLine-Mastercard-CAD,,0,0,0,13413.49,13413.49,13413.49,118872817.36999993,118872817.36999993,ACH,CAD
2025-02-12,Settlement from ClientLine,Processor Payout Batch,SET-20250210-ClientLine-Mastercard-EUR,,0,0,0,64287.48,64287.48,64287.48,118937104.84999993,118937104.84999993,ACH,EUR
2025-02-12,Settlement from ClientLine,Processor Payout Batch,SET-20250210-ClientLine-Mastercard-GBP,,0,0,0,46271.15,46271.15,46271.15,118983375.99999994,118983375.99999994,ACH,GBP
2025-02-12,Settlement from ClientLine,Processor Payout Batch,SET-20250210-ClientLine-Mastercard-USD,,0,0,0,138689.96,138689.96,138689.96,119122065.95999993,119122065.95999993,ACH,USD
2025-02-12,Settlement from ClientLine,Processor Payout Batch,SET-20250210-ClientLine-Visa-CAD,,0,0,0,28808.25,28808.25,28808.25,119150874.20999993,119150874.20999993,ACH,CAD
2025-02-12,Settlement from GoCardless,Processor Payout Batch,SET-20250210-GoCardless-N/A-EUR,,0,0,0,207458.09,207458.09,207458.09,119358332.29999994,119358332.29999994,ACH,EUR
2025-02-12,Settlement from ClientLine,Processor Payout Batch,SET-20250210-ClientLine-Visa-GBP,,0,0,0,25269.64,25269.64,25269.64,119383601.93999994,119383601.93999994,ACH,GBP
2025-02-12,Settlement from ClientLine,Processor Payout Batch,SET-20250210-ClientLine-Visa-USD,,0,0,0,210239.67,210239.67,210239.67,119593841.60999994,119593841.60999994,ACH,USD
2025-02-12,Settlement from GoCardless,Processor Payout Batch,SET-20250210-GoCardless-N/A-AUD,,0,0,0,78466.17,78466.17,78466.17,119672307.77999994,119672307.77999994,ACH,AUD
2025-02-12,Settlement from GoCardless,Processor Payout Batch,SET-20250210-GoCardless-N/A-CAD,,0,0,0,56305.84,56305.84,56305.84,119728613.61999995,119728613.61999995,ACH,CAD
2025-02-12,Settlement from GoCardless,Processor Payout Batch,SET-20250210-GoCardless-N/A-GBP,,0,0,0,91033.14,91033.14,91033.14,119819646.75999995,119819646.75999995,ACH,GBP
2025-02-12,Settlement from GoCardless,Processor Payout Batch,SET-20250210-GoCardless-N/A-USD,,0,0,0,709519.97,709519.97,709519.97,120529166.72999994,120529166.72999994,ACH,USD
2025-02-12,Settlement from PayPal,Processor Payout Batch,SET-20250210-PayPal-N/A-AUD,,0,0,0,106524.09,106524.09,106524.09,120635690.81999995,120635690.81999995,ACH,AUD
2025-02-12,Settlement from PayPal,Processor Payout Batch,SET-20250210-PayPal-N/A-CAD,,0,0,0,79287.32,79287.32,79287.32,120714978.13999994,120714978.13999994,ACH,CAD
2025-02-12,Settlement from PayPal,Processor Payout Batch,SET-20250210-PayPal-N/A-EUR,,0,0,0,125174.01,125174.01,125174.01,120840152.14999995,120840152.14999995,ACH,EUR
2025-02-12,Settlement from PayPal,Processor Payout Batch,SET-20250210-PayPal-N/A-GBP,,0,0,0,105970.0,105970.0,105970.0,120946122.14999995,120946122.14999995,ACH,GBP
2025-02-12,Settlement from Amex,Processor Payout Batch,SET-20250210-Amex-Amex-CAD,,0,0,0,13315.93,13315.93,13315.93,120959438.07999995,120959438.07999995,ACH,CAD
2025-02-12,Settlement from ClientLine,Processor Payout Batch,SET-20250210-ClientLine-Visa-EUR,,0,0,0,48405.35,48405.35,48405.35,121007843.42999995,121007843.42999995,ACH,EUR
2025-02-12,Settlement from Amex,Processor Payout Batch,SET-20250210-Amex-Amex-AUD,,0,0,0,48270.94,48270.94,48270.94,121056114.36999995,121056114.36999995,ACH,AUD
2025-02-12,Settlement from GoCardless,Processor Payout Batch,SET-20250208-GoCardless-N/A-GBP,,0,0,0,110240.37,110240.37,110240.37,121166354.73999995,121166354.73999995,ACH,GBP
2025-02-12,Settlement from PayPal,Processor Payout Batch,SET-20250208-PayPal-N/A-USD,,0,0,0,659940.22,659940.22,659940.22,121826294.95999995,121826294.95999995,ACH,USD
2025-02-12,Settlement from PayPal,Processor Payout Batch,SET-20250208-PayPal-N/A-EUR,,0,0,0,140247.4,140247.4,140247.4,121966542.35999995,121966542.35999995,ACH,EUR
2025-02-12,Settlement from PayPal,Processor Payout Batch,SET-20250208-PayPal-N/A-CAD,,0,0,0,91190.23,91190.23,91190.23,122057732.58999996,122057732.58999996,ACH,CAD
2025-02-12,Settlement from PayPal,Processor Payout Batch,SET-20250208-PayPal-N/A-AUD,,0,0,0,85707.08,85707.08,85707.08,122143439.66999996,122143439.66999996,ACH,AUD
2025-02-12,Settlement from GoCardless,Processor Payout Batch,SET-20250208-GoCardless-N/A-USD,,0,0,0,642406.07,642406.07,642406.07,122785845.73999995,122785845.73999995,ACH,USD
2025-02-12,Settlement from GoCardless,Processor Payout Batch,SET-20250208-GoCardless-N/A-EUR,,0,0,0,133515.62,133515.62,133515.62,122919361.35999995,122919361.35999995,ACH,EUR
2025-02-12,Settlement from GoCardless,Processor Payout Batch,SET-20250208-GoCardless-N/A-CAD,,0,0,0,48577.27,48577.27,48577.27,122967938.62999995,122967938.62999995,ACH,CAD
2025-02-12,Settlement from GoCardless,Processor Payout Batch,SET-20250208-GoCardless-N/A-AUD,,0,0,0,88136.32,88136.32,88136.32,123056074.94999994,123056074.94999994,ACH,AUD
2025-02-12,Settlement from ClientLine,Processor Payout Batch,SET-20250208-ClientLine-Visa-USD,,0,0,0,201841.19,201841.19,201841.19,123257916.13999994,123257916.13999994,ACH,USD
2025-02-12,Settlement from ClientLine,Processor Payout Batch,SET-20250208-ClientLine-Visa-GBP,,0,0,0,29937.83,29937.83,29937.83,123287853.96999994,123287853.96999994,ACH,GBP
2025-02-12,Settlement from ClientLine,Processor Payout Batch,SET-20250208-ClientLine-Visa-EUR,,0,0,0,44922.18,44922.18,44922.18,123332776.14999995,123332776.14999995,ACH,EUR
2025-02-12,Settlement from ClientLine,Processor Payout Batch,SET-20250208-ClientLine-Visa-CAD,,0,0,0,28752.15,28752.15,28752.15,123361528.29999995,123361528.29999995,ACH,CAD
2025-02-12,Settlement from ClientLine,Processor Payout Batch,SET-20250208-ClientLine-Visa-AUD,,0,0,0,25283.67,25283.67,25283.67,123386811.96999995,123386811.96999995,ACH,AUD
2025-02-12,Settlement from ClientLine,Processor Payout Batch,SET-20250208-ClientLine-Mastercard-USD,,0,0,0,221062.91,221062.91,221062.91,123607874.87999995,123607874.87999995,ACH,USD
2025-02-12,Settlement from ClientLine,Processor Payout Batch,SET-20250208-ClientLine-Mastercard-GBP,,0,0,0,26290.52,26290.52,26290.52,123634165.39999995,123634165.39999995,ACH,GBP
2025-02-12,Settlement from ClientLine,Processor Payout Batch,SET-20250208-ClientLine-Mastercard-EUR,,0,0,0,42828.93,42828.93,42828.93,123676994.32999995,123676994.32999995,ACH,EUR
2025-02-12,Settlement from ClientLine,Processor Payout Batch,SET-20250208-ClientLine-Mastercard-CAD,,0,0,0,32175.28,32175.28,32175.28,123709169.60999995,123709169.60999995,ACH,CAD
2025-02-12,Settlement from ClientLine,Processor Payout Batch,SET-20250208-ClientLine-Mastercard-AUD,,0,0,0,25900.44,25900.44,25900.44,123735070.04999995,123735070.04999995,ACH,AUD
2025-02-12,Settlement from Amex,Processor Payout Batch,SET-20250208-Amex-Amex-USD,,0,0,0,202753.37,202753.37,202753.37,123937823.41999996,123937823.41999996,ACH,USD
2025-02-12,Settlement from Amex,Processor Payout Batch,SET-20250208-Amex-Amex-GBP,,0,0,0,36255.83,36255.83,36255.83,123974079.24999996,123974079.24999996,ACH,GBP
2025-02-12,Settlement from Amex,Processor Payout Batch,SET-20250208-Amex-Amex-EUR,,0,0,0,35585.03,35585.03,35585.03,124009664.27999996,124009664.27999996,ACH,EUR
2025-02-12,Settlement from Amex,Processor Payout Batch,SET-20250208-Amex-Amex-CAD,,0,0,0,16780.68,16780.68,16780.68,124026444.95999996,124026444.95999996,ACH,CAD
2025-02-12,Settlement from PayPal,Processor Payout Batch,SET-20250208-PayPal-N/A-GBP,,0,0,0,60664.54,60664.54,60664.54,124087109.49999997,124087109.49999997,ACH,GBP
2025-02-12,Settlement from Amex,Processor Payout Batch,SET-20250208-Amex-Amex-AUD,,0,0,0,43287.31,43287.31,43287.31,124130396.80999997,124130396.80999997,ACH,AUD
2025-02-13,Settlement from Amex,Processor Payout Batch,SET-20250209-Amex-Amex-CAD,,0,0,0,14948.55,14948.55,14948.55,124145345.35999997,124145345.35999997,ACH,CAD
2025-02-13,Settlement from Amex,Processor Payout Batch,SET-20250211-Amex-Amex-GBP,,0,0,0,37988.14,37988.14,37988.14,124183333.49999997,124183333.49999997,ACH,GBP
2025-02-13,Settlement from PayPal,Processor Payout Batch,SET-20250211-PayPal-N/A-USD,,0,0,0,608579.5,608579.5,608579.5,124791912.99999997,124791912.99999997,ACH,USD
2025-02-13,Settlement from PayPal,Processor Payout Batch,SET-20250211-PayPal-N/A-GBP,,0,0,0,117786.57,117786.57,117786.57,124909699.56999996,124909699.56999996,ACH,GBP
2025-02-13,Settlement from PayPal,Processor Payout Batch,SET-20250211-PayPal-N/A-EUR,,0,0,0,132401.07,132401.07,132401.07,125042100.63999996,125042100.63999996,ACH,EUR
2025-02-13,Settlement from PayPal,Processor Payout Batch,SET-20250211-PayPal-N/A-CAD,,0,0,0,66387.6,66387.6,66387.6,125108488.23999995,125108488.23999995,ACH,CAD
2025-02-13,Settlement from PayPal,Processor Payout Batch,SET-20250211-PayPal-N/A-AUD,,0,0,0,95624.03,95624.03,95624.03,125204112.26999995,125204112.26999995,ACH,AUD
2025-02-13,Settlement from GoCardless,Processor Payout Batch,SET-20250211-GoCardless-N/A-USD,,0,0,0,582076.86,582076.86,582076.86,125786189.12999995,125786189.12999995,ACH,USD
2025-02-13,Settlement from GoCardless,Processor Payout Batch,SET-20250211-GoCardless-N/A-GBP,,0,0,0,151416.87,151416.87,151416.87,125937605.99999996,125937605.99999996,ACH,GBP
2025-02-13,Settlement from GoCardless,Processor Payout Batch,SET-20250211-GoCardless-N/A-EUR,,0,0,0,131849.39,131849.39,131849.39,126069455.38999996,126069455.38999996,ACH,EUR
2025-02-13,Settlement from GoCardless,Processor Payout Batch,SET-20250211-GoCardless-N/A-CAD,,0,0,0,73669.6,73669.6,73669.6,126143124.98999995,126143124.98999995,ACH,CAD
2025-02-13,Settlement from GoCardless,Processor Payout Batch,SET-20250211-GoCardless-N/A-AUD,,0,0,0,101761.16,101761.16,101761.16,126244886.14999995,126244886.14999995,ACH,AUD
2025-02-13,Settlement from ClientLine,Processor Payout Batch,SET-20250211-ClientLine-Visa-USD,,0,0,0,220802.42,220802.42,220802.42,126465688.56999995,126465688.56999995,ACH,USD
2025-02-13,Settlement from ClientLine,Processor Payout Batch,SET-20250211-ClientLine-Visa-GBP,,0,0,0,32196.5,32196.5,32196.5,126497885.06999995,126497885.06999995,ACH,GBP
2025-02-13,Settlement from ClientLine,Processor Payout Batch,SET-20250211-ClientLine-Visa-EUR,,0,0,0,51148.17,51148.17,51148.17,126549033.23999995,126549033.23999995,ACH,EUR
2025-02-13,Settlement from ClientLine,Processor Payout Batch,SET-20250211-ClientLine-Visa-CAD,,0,0,0,28401.35,28401.35,28401.35,126577434.58999994,126577434.58999994,ACH,CAD
2025-02-13,Settlement from ClientLine,Processor Payout Batch,SET-20250211-ClientLine-Visa-AUD,,0,0,0,24257.56,24257.56,24257.56,126601692.14999995,126601692.14999995,ACH,AUD
2025-02-13,Settlement from ClientLine,Processor Payout Batch,SET-20250211-ClientLine-Mastercard-USD,,0,0,0,220683.23,220683.23,220683.23,126822375.37999995,126822375.37999995,ACH,USD
2025-02-13,Settlement from ClientLine,Processor Payout Batch,SET-20250211-ClientLine-Mastercard-GBP,,0,0,0,36792.81,36792.81,36792.81,126859168.18999995,126859168.18999995,ACH,GBP
2025-02-13,Settlement from ClientLine,Processor Payout Batch,SET-20250211-ClientLine-Mastercard-EUR,,0,0,0,50089.65,50089.65,50089.65,126909257.83999996,126909257.83999996,ACH,EUR
2025-02-13,Settlement from Amex,Processor Payout Batch,SET-20250209-Amex-Amex-AUD,,0,0,0,16000.41,16000.41,16000.41,126925258.24999996,126925258.24999996,ACH,AUD
2025-02-13,Settlement from ClientLine,Processor Payout Batch,SET-20250211-ClientLine-Mastercard-AUD,,0,0,0,25315.03,25315.03,25315.03,126950573.27999996,126950573.27999996,ACH,AUD
2025-02-13,Settlement from Amex,Processor Payout Batch,SET-20250211-Amex-Amex-USD,,0,0,0,190522.04,190522.04,190522.04,127141095.31999996,127141095.31999996,ACH,USD
2025-02-13,Settlement from Amex,Processor Payout Batch,SET-20250211-Amex-Amex-EUR,,0,0,0,56240.03,56240.03,56240.03,127197335.34999996,127197335.34999996,ACH,EUR
2025-02-13,Settlement from Amex,Processor Payout Batch,SET-20250211-Amex-Amex-CAD,,0,0,0,16790.83,16790.83,16790.83,127214126.17999996,127214126.17999996,ACH,CAD
2025-02-13,Settlement from ClientLine,Processor Payout Batch,SET-20250211-ClientLine-Mastercard-CAD,,0,0,0,10686.23,10686.23,10686.23,127224812.40999997,127224812.40999997,ACH,CAD
2025-02-13,Settlement from ClientLine,Processor Payout Batch,SET-20250209-ClientLine-Mastercard-EUR,,0,0,0,44867.77,44867.77,44867.77,127269680.17999996,127269680.17999996,ACH,EUR
2025-02-13,Settlement from Amex,Processor Payout Batch,SET-20250209-Amex-Amex-EUR,,0,0,0,30966.16,30966.16,30966.16,127300646.33999996,127300646.33999996,ACH,EUR
2025-02-13,Settlement from Amex,Processor Payout Batch,SET-20250209-Amex-Amex-GBP,,0,0,0,30656.98,30656.98,30656.98,127331303.31999996,127331303.31999996,ACH,GBP
2025-02-13,Settlement from Amex,Processor Payout Batch,SET-20250209-Amex-Amex-USD,,0,0,0,220648.55,220648.55,220648.55,127551951.86999996,127551951.86999996,ACH,USD
2025-02-13,Settlement from ClientLine,Processor Payout Batch,SET-20250209-ClientLine-Mastercard-AUD,,0,0,0,25873.39,25873.39,25873.39,127577825.25999996,127577825.25999996,ACH,AUD
2025-02-13,Settlement from ClientLine,Processor Payout Batch,SET-20250209-ClientLine-Mastercard-CAD,,0,0,0,17282.28,17282.28,17282.28,127595107.53999996,127595107.53999996,ACH,CAD
2025-02-13,Settlement from ClientLine,Processor Payout Batch,SET-20250209-ClientLine-Mastercard-GBP,,0,0,0,40508.23,40508.23,40508.23,127635615.76999997,127635615.76999997,ACH,GBP
2025-02-13,Settlement from ClientLine,Processor Payout Batch,SET-20250209-ClientLine-Mastercard-USD,,0,0,0,196186.37,196186.37,196186.37,127831802.13999997,127831802.13999997,ACH,USD
2025-02-13,Settlement from ClientLine,Processor Payout Batch,SET-20250209-ClientLine-Visa-AUD,,0,0,0,25479.01,25479.01,25479.01,127857281.14999998,127857281.14999998,ACH,AUD
2025-02-13,Settlement from Amex,Processor Payout Batch,SET-20250211-Amex-Amex-AUD,,0,0,0,30273.12,30273.12,30273.12,127887554.26999998,127887554.26999998,ACH,AUD
2025-02-13,Settlement from ClientLine,Processor Payout Batch,SET-20250209-ClientLine-Visa-EUR,,0,0,0,18540.06,18540.06,18540.06,127906094.32999998,127906094.32999998,ACH,EUR
2025-02-13,Settlement from ClientLine,Processor Payout Batch,SET-20250209-ClientLine-Visa-GBP,,0,0,0,35881.23,35881.23,35881.23,127941975.55999999,127941975.55999999,ACH,GBP
2025-02-13,Settlement from ClientLine,Processor Payout Batch,SET-20250209-ClientLine-Visa-CAD,,0,0,0,20525.05,20525.05,20525.05,127962500.60999998,127962500.60999998,ACH,CAD
2025-02-13,Settlement from GoCardless,Processor Payout Batch,SET-20250209-GoCardless-N/A-AUD,,0,0,0,78531.13,78531.13,78531.13,128041031.73999998,128041031.73999998,ACH,AUD
2025-02-13,Settlement from GoCardless,Processor Payout Batch,SET-20250209-GoCardless-N/A-CAD,,0,0,0,96943.13,96943.13,96943.13,128137974.86999997,128137974.86999997,ACH,CAD
2025-02-13,Settlement from GoCardless,Processor Payout Batch,SET-20250209-GoCardless-N/A-EUR,,0,0,0,211902.59,211902.59,211902.59,128349877.45999998,128349877.45999998,ACH,EUR
2025-02-13,Settlement from GoCardless,Processor Payout Batch,SET-20250209-GoCardless-N/A-GBP,,0,0,0,88772.21,88772.21,88772.21,128438649.66999997,128438649.66999997,ACH,GBP
2025-02-13,Settlement from GoCardless,Processor Payout Batch,SET-20250209-GoCardless-N/A-USD,,0,0,0,629782.34,629782.34,629782.34,129068432.00999998,129068432.00999998,ACH,USD
2025-02-13,Settlement from PayPal,Processor Payout Batch,SET-20250209-PayPal-N/A-AUD,,0,0,0,84367.91,84367.91,84367.91,129152799.91999997,129152799.91999997,ACH,AUD
2025-02-13,Settlement from PayPal,Processor Payout Batch,SET-20250209-PayPal-N/A-CAD,,0,0,0,87981.44,87981.44,87981.44,129240781.35999997,129240781.35999997,ACH,CAD
2025-02-13,Settlement from PayPal,Processor Payout Batch,SET-20250209-PayPal-N/A-EUR,,0,0,0,147542.83,147542.83,147542.83,129388324.18999997,129388324.18999997,ACH,EUR
2025-02-13,Settlement from PayPal,Processor Payout Batch,SET-20250209-PayPal-N/A-GBP,,0,0,0,93374.89,93374.89,93374.89,129481699.07999997,129481699.07999997,ACH,GBP
2025-02-13,Settlement from PayPal,Processor Payout Batch,SET-20250209-PayPal-N/A-USD,,0,0,0,603789.34,603789.34,603789.34,130085488.41999997,130085488.41999997,ACH,USD
2025-02-13,Settlement from ClientLine,Processor Payout Batch,SET-20250209-ClientLine-Visa-USD,,0,0,0,233258.1,233258.1,233258.1,130318746.51999997,130318746.51999997,ACH,USD
2025-02-14,Settlement from GoCardless,Processor Payout Batch,SET-20250212-GoCardless-N/A-AUD,,0,0,0,118284.95,118284.95,118284.95,130437031.46999997,130437031.46999997,ACH,AUD
2025-02-14,Settlement from GoCardless,Processor Payout Batch,SET-20250212-GoCardless-N/A-CAD,,0,0,0,80511.43,80511.43,80511.43,130517542.89999998,130517542.89999998,ACH,CAD
2025-02-14,Settlement from GoCardless,Processor Payout Batch,SET-20250212-GoCardless-N/A-EUR,,0,0,0,149476.8,149476.8,149476.8,130667019.69999997,130667019.69999997,ACH,EUR
2025-02-14,Settlement from GoCardless,Processor Payout Batch,SET-20250212-GoCardless-N/A-GBP,,0,0,0,121300.12,121300.12,121300.12,130788319.81999998,130788319.81999998,ACH,GBP
2025-02-14,Settlement from GoCardless,Processor Payout Batch,SET-20250212-GoCardless-N/A-USD,,0,0,0,636484.69,636484.69,636484.69,131424804.50999998,131424804.50999998,ACH,USD
2025-02-14,Settlement from ClientLine,Processor Payout Batch,SET-20250212-ClientLine-Mastercard-CAD,,0,0,0,29051.69,29051.69,29051.69,131453856.19999997,131453856.19999997,ACH,CAD
2025-02-14,Settlement from PayPal,Processor Payout Batch,SET-20250212-PayPal-N/A-CAD,,0,0,0,73193.49,73193.49,73193.49,131527049.68999997,131527049.68999997,ACH,CAD
2025-02-14,Settlement from PayPal,Processor Payout Batch,SET-20250212-PayPal-N/A-EUR,,0,0,0,131349.18,131349.18,131349.18,131658398.86999997,131658398.86999997,ACH,EUR
2025-02-14,Settlement from PayPal,Processor Payout Batch,SET-20250212-PayPal-N/A-GBP,,0,0,0,65726.56,65726.56,65726.56,131724125.42999998,131724125.42999998,ACH,GBP
2025-02-14,Settlement from PayPal,Processor Payout Batch,SET-20250212-PayPal-N/A-USD,,0,0,0,618323.21,618323.21,618323.21,132342448.63999997,132342448.63999997,ACH,USD
2025-02-14,Settlement from ClientLine,Processor Payout Batch,SET-20250212-ClientLine-Visa-USD,,0,0,0,190265.74,190265.74,190265.74,132532714.37999997,132532714.37999997,ACH,USD
2025-02-14,Settlement from PayPal,Processor Payout Batch,SET-20250212-PayPal-N/A-AUD,,0,0,0,115887.86,115887.86,115887.86,132648602.23999996,132648602.23999996,ACH,AUD
2025-02-14,Settlement from ClientLine,Processor Payout Batch,SET-20250212-ClientLine-Visa-GBP,,0,0,0,46728.64,46728.64,46728.64,132695330.87999997,132695330.87999997,ACH,GBP
2025-02-14,Settlement from Amex,Processor Payout Batch,SET-20250212-Amex-Amex-EUR,,0,0,0,55769.26,55769.26,55769.26,132751100.13999997,132751100.13999997,ACH,EUR
2025-02-14,Settlement from ClientLine,Processor Payout Batch,SET-20250212-ClientLine-Visa-CAD,,0,0,0,24558.24,24558.24,24558.24,132775658.37999997,132775658.37999997,ACH,CAD
2025-02-14,Settlement from ClientLine,Processor Payout Batch,SET-20250212-ClientLine-Visa-AUD,,0,0,0,20255.69,20255.69,20255.69,132795914.06999996,132795914.06999996,ACH,AUD
2025-02-14,Settlement from ClientLine,Processor Payout Batch,SET-20250212-ClientLine-Mastercard-USD,,0,0,0,213132.36,213132.36,213132.36,133009046.42999996,133009046.42999996,ACH,USD
2025-02-14,Settlement from ClientLine,Processor Payout Batch,SET-20250212-ClientLine-Mastercard-GBP,,0,0,0,46606.66,46606.66,46606.66,133055653.08999996,133055653.08999996,ACH,GBP
2025-02-14,Settlement from ClientLine,Processor Payout Batch,SET-20250212-ClientLine-Mastercard-EUR,,0,0,0,51644.82,51644.82,51644.82,133107297.90999995,133107297.90999995,ACH,EUR
2025-02-14,Settlement from ClientLine,Processor Payout Batch,SET-20250212-ClientLine-Mastercard-AUD,,0,0,0,33820.72,33820.72,33820.72,133141118.62999995,133141118.62999995,ACH,AUD
2025-02-14,Settlement from Amex,Processor Payout Batch,SET-20250212-Amex-Amex-USD,,0,0,0,205686.24,205686.24,205686.24,133346804.86999995,133346804.86999995,ACH,USD
2025-02-14,Settlement from Amex,Processor Payout Batch,SET-20250212-Amex-Amex-GBP,,0,0,0,32815.35,32815.35,32815.35,133379620.21999994,133379620.21999994,ACH,GBP
2025-02-14,Settlement from Amex,Processor Payout Batch,SET-20250212-Amex-Amex-CAD,,0,0,0,31758.9,31758.9,31758.9,133411379.11999995,133411379.11999995,ACH,CAD
2025-02-14,Settlement from Amex,Processor Payout Batch,SET-20250212-Amex-Amex-AUD,,0,0,0,30488.23,30488.23,30488.23,133441867.34999995,133441867.34999995,ACH,AUD
2025-02-14,Settlement from ClientLine,Processor Payout Batch,SET-20250212-ClientLine-Visa-EUR,,0,0,0,61448.25,61448.25,61448.25,133503315.59999995,133503315.59999995,ACH,EUR
2025-02-17,Settlement from GoCardless,Processor Payout Batch,SET-20250213-GoCardless-N/A-GBP,,0,0,0,90265.48,90265.48,90265.48,133593581.07999995,133593581.07999995,ACH,GBP
2025-02-17,Settlement from GoCardless,Processor Payout Batch,SET-20250213-GoCardless-N/A-AUD,,0,0,0,116142.43,116142.43,116142.43,133709723.50999996,133709723.50999996,ACH,AUD
2025-02-17,Settlement from GoCardless,Processor Payout Batch,SET-20250213-GoCardless-N/A-CAD,,0,0,0,89201.01,89201.01,89201.01,133798924.51999997,133798924.51999997,ACH,CAD
2025-02-17,Settlement from GoCardless,Processor Payout Batch,SET-20250213-GoCardless-N/A-EUR,,0,0,0,190996.33,190996.33,190996.33,133989920.84999996,133989920.84999996,ACH,EUR
2025-02-17,Settlement from GoCardless,Processor Payout Batch,SET-20250213-GoCardless-N/A-USD,,0,0,0,555496.12,555496.12,555496.12,134545416.96999997,134545416.96999997,ACH,USD
2025-02-17,Settlement from ClientLine,Processor Payout Batch,SET-20250213-ClientLine-Visa-USD,,0,0,0,197151.61,197151.61,197151.61,134742568.57999998,134742568.57999998,ACH,USD
2025-02-17,Settlement from PayPal,Processor Payout Batch,SET-20250213-PayPal-N/A-CAD,,0,0,0,63497.98,63497.98,63497.98,134806066.55999997,134806066.55999997,ACH,CAD
2025-02-17,Settlement from PayPal,Processor Payout Batch,SET-20250213-PayPal-N/A-EUR,,0,0,0,168804.6,168804.6,168804.6,134974871.15999997,134974871.15999997,ACH,EUR
2025-02-17,Settlement from PayPal,Processor Payout Batch,SET-20250213-PayPal-N/A-GBP,,0,0,0,112696.82,112696.82,112696.82,135087567.97999996,135087567.97999996,ACH,GBP
2025-02-17,Settlement from PayPal,Processor Payout Batch,SET-20250213-PayPal-N/A-USD,,0,0,0,543653.23,543653.23,543653.23,135631221.20999995,135631221.20999995,ACH,USD
2025-02-17,Settlement from PayPal,Processor Payout Batch,SET-20250213-PayPal-N/A-AUD,,0,0,0,72918.01,72918.01,72918.01,135704139.21999994,135704139.21999994,ACH,AUD
2025-02-17,Settlement from ClientLine,Processor Payout Batch,SET-20250213-ClientLine-Visa-GBP,,0,0,0,45011.85,45011.85,45011.85,135749151.06999993,135749151.06999993,ACH,GBP
2025-02-17,Settlement from ClientLine,Processor Payout Batch,SET-20250213-ClientLine-Visa-EUR,,0,0,0,82113.83,82113.83,82113.83,135831264.89999995,135831264.89999995,ACH,EUR
2025-02-17,Settlement from ClientLine,Processor Payout Batch,SET-20250213-ClientLine-Visa-CAD,,0,0,0,32191.51,32191.51,32191.51,135863456.40999994,135863456.40999994,ACH,CAD
2025-02-17,Settlement from Amex,Processor Payout Batch,SET-20250213-Amex-Amex-CAD,,0,0,0,24273.09,24273.09,24273.09,135887729.49999994,135887729.49999994,ACH,CAD
2025-02-17,Settlement from Amex,Processor Payout Batch,SET-20250213-Amex-Amex-EUR,,0,0,0,60433.76,60433.76,60433.76,135948163.25999993,135948163.25999993,ACH,EUR
2025-02-17,Settlement from Amex,Processor Payout Batch,SET-20250213-Amex-Amex-GBP,,0,0,0,22088.72,22088.72,22088.72,135970251.97999993,135970251.97999993,ACH,GBP
2025-02-17,Settlement from Amex,Processor Payout Batch,SET-20250213-Amex-Amex-USD,,0,0,0,189449.25,189449.25,189449.25,136159701.22999993,136159701.22999993,ACH,USD
2025-02-17,Settlement from ClientLine,Processor Payout Batch,SET-20250213-ClientLine-Mastercard-AUD,,0,0,0,27911.38,27911.38,27911.38,136187612.60999992,136187612.60999992,ACH,AUD
2025-02-17,Settlement from Amex,Processor Payout Batch,SET-20250213-Amex-Amex-AUD,,0,0,0,15039.38,15039.38,15039.38,136202651.98999992,136202651.98999992,ACH,AUD
2025-02-17,Settlement from ClientLine,Processor Payout Batch,SET-20250213-ClientLine-Mastercard-EUR,,0,0,0,49421.71,49421.71,49421.71,136252073.69999993,136252073.69999993,ACH,EUR
2025-02-17,Settlement from ClientLine,Processor Payout Batch,SET-20250213-ClientLine-Mastercard-GBP,,0,0,0,26570.27,26570.27,26570.27,136278643.96999994,136278643.96999994,ACH,GBP
2025-02-17,Settlement from ClientLine,Processor Payout Batch,SET-20250213-ClientLine-Mastercard-USD,,0,0,0,239106.58,239106.58,239106.58,136517750.54999995,136517750.54999995,ACH,USD
2025-02-17,Settlement from ClientLine,Processor Payout Batch,SET-20250213-ClientLine-Visa-AUD,,0,0,0,17583.91,17583.91,17583.91,136535334.45999995,136535334.45999995,ACH,AUD
2025-02-17,Settlement from ClientLine,Processor Payout Batch,SET-20250213-ClientLine-Mastercard-CAD,,0,0,0,17736.41,17736.41,17736.41,136553070.86999995,136553070.86999995,ACH,CAD
2025-02-18,Settlement from ClientLine,Processor Payout Batch,SET-20250214-ClientLine-Visa-USD,,0,0,0,222067.48,222067.48,222067.48,136775138.34999993,136775138.34999993,ACH,USD
2025-02-18,Settlement from GoCardless,Processor Payout Batch,SET-20250214-GoCardless-N/A-AUD,,0,0,0,81485.13,81485.13,81485.13,136856623.47999993,136856623.47999993,ACH,AUD
2025-02-18,Settlement from GoCardless,Processor Payout Batch,SET-20250214-GoCardless-N/A-CAD,,0,0,0,84644.58,84644.58,84644.58,136941268.05999994,136941268.05999994,ACH,CAD
2025-02-18,Settlement from GoCardless,Processor Payout Batch,SET-20250214-GoCardless-N/A-EUR,,0,0,0,155509.74,155509.74,155509.74,137096777.79999995,137096777.79999995,ACH,EUR
2025-02-18,Settlement from GoCardless,Processor Payout Batch,SET-20250214-GoCardless-N/A-USD,,0,0,0,606904.77,606904.77,606904.77,137703682.56999996,137703682.56999996,ACH,USD
2025-02-18,Settlement from PayPal,Processor Payout Batch,SET-20250214-PayPal-N/A-CAD,,0,0,0,82833.83,82833.83,82833.83,137786516.39999998,137786516.39999998,ACH,CAD
2025-02-18,Settlement from PayPal,Processor Payout Batch,SET-20250214-PayPal-N/A-EUR,,0,0,0,109879.81,109879.81,109879.81,137896396.20999998,137896396.20999998,ACH,EUR
2025-02-18,Settlement from PayPal,Processor Payout Batch,SET-20250214-PayPal-N/A-GBP,,0,0,0,109100.5,109100.5,109100.5,138005496.70999998,138005496.70999998,ACH,GBP
2025-02-18,Settlement from PayPal,Processor Payout Batch,SET-20250214-PayPal-N/A-USD,,0,0,0,684766.63,684766.63,684766.63,138690263.33999997,138690263.33999997,ACH,USD
2025-02-18,Settlement from ClientLine,Processor Payout Batch,SET-20250214-ClientLine-Visa-GBP,,0,0,0,43827.08,43827.08,43827.08,138734090.42,138734090.42,ACH,GBP
2025-02-18,Settlement from PayPal,Processor Payout Batch,SET-20250214-PayPal-N/A-AUD,,0,0,0,109916.59,109916.59,109916.59,138844007.01,138844007.01,ACH,AUD
2025-02-18,Settlement from ClientLine,Processor Payout Batch,SET-20250214-ClientLine-Visa-EUR,,0,0,0,57539.68,57539.68,57539.68,138901546.69,138901546.69,ACH,EUR
2025-02-18,Settlement from GoCardless,Processor Payout Batch,SET-20250214-GoCardless-N/A-GBP,,0,0,0,83468.17,83468.17,83468.17,138985014.85999998,138985014.85999998,ACH,GBP
2025-02-18,Settlement from ClientLine,Processor Payout Batch,SET-20250214-ClientLine-Visa-AUD,,0,0,0,38330.97,38330.97,38330.97,139023345.82999998,139023345.82999998,ACH,AUD
2025-02-18,Settlement from ClientLine,Processor Payout Batch,SET-20250214-ClientLine-Visa-CAD,,0,0,0,24850.98,24850.98,24850.98,139048196.80999997,139048196.80999997,ACH,CAD
2025-02-18,Settlement from Amex,Processor Payout Batch,SET-20250214-Amex-Amex-CAD,,0,0,0,26758.11,26758.11,26758.11,139074954.92,139074954.92,ACH,CAD
2025-02-18,Settlement from Amex,Processor Payout Batch,SET-20250214-Amex-Amex-EUR,,0,0,0,49563.78,49563.78,49563.78,139124518.7,139124518.7,ACH,EUR
2025-02-18,Settlement from Amex,Processor Payout Batch,SET-20250214-Amex-Amex-GBP,,0,0,0,26863.18,26863.18,26863.18,139151381.88,139151381.88,ACH,GBP
2025-02-18,Settlement from Amex,Processor Payout Batch,SET-20250214-Amex-Amex-USD,,0,0,0,165996.67,165996.67,165996.67,139317378.54999998,139317378.54999998,ACH,USD
2025-02-18,Settlement from Amex,Processor Payout Batch,SET-20250214-Amex-Amex-AUD,,0,0,0,16251.67,16251.67,16251.67,139333630.21999997,139333630.21999997,ACH,AUD
2025-02-18,Settlement from ClientLine,Processor Payout Batch,SET-20250214-ClientLine-Mastercard-CAD,,0,0,0,15140.66,15140.66,15140.66,139348770.87999997,139348770.87999997,ACH,CAD
2025-02-18,Settlement from ClientLine,Processor Payout Batch,SET-20250214-ClientLine-Mastercard-EUR,,0,0,0,40437.66,40437.66,40437.66,139389208.53999996,139389208.53999996,ACH,EUR
2025-02-18,Settlement from ClientLine,Processor Payout Batch,SET-20250214-ClientLine-Mastercard-GBP,,0,0,0,24457.45,24457.45,24457.45,139413665.98999995,139413665.98999995,ACH,GBP
2025-02-18,Settlement from ClientLine,Processor Payout Batch,SET-20250214-ClientLine-Mastercard-USD,,0,0,0,198473.34,198473.34,198473.34,139612139.32999995,139612139.32999995,ACH,USD
2025-02-18,Settlement from ClientLine,Processor Payout Batch,SET-20250214-ClientLine-Mastercard-AUD,,0,0,0,17325.61,17325.61,17325.61,139629464.93999997,139629464.93999997,ACH,AUD
2025-02-19,Settlement from Amex,Processor Payout Batch,SET-20250217-Amex-Amex-AUD,,0,0,0,17263.7,17263.7,17263.7,139646728.63999996,139646728.63999996,ACH,AUD
2025-02-19,Settlement from ClientLine,Processor Payout Batch,SET-20250217-ClientLine-Mastercard-USD,,0,0,0,212857.71,212857.71,212857.71,139859586.34999996,139859586.34999996,ACH,USD
2025-02-19,Settlement from Amex,Processor Payout Batch,SET-20250217-Amex-Amex-CAD,,0,0,0,22250.86,22250.86,22250.86,139881837.20999998,139881837.20999998,ACH,CAD
2025-02-19,Settlement from Amex,Processor Payout Batch,SET-20250217-Amex-Amex-EUR,,0,0,0,47979.42,47979.42,47979.42,139929816.62999997,139929816.62999997,ACH,EUR
2025-02-19,Settlement from Amex,Processor Payout Batch,SET-20250217-Amex-Amex-GBP,,0,0,0,25607.44,25607.44,25607.44,139955424.06999996,139955424.06999996,ACH,GBP
2025-02-19,Settlement from Amex,Processor Payout Batch,SET-20250217-Amex-Amex-USD,,0,0,0,195505.7,195505.7,195505.7,140150929.76999995,140150929.76999995,ACH,USD
2025-02-19,Settlement from ClientLine,Processor Payout Batch,SET-20250217-ClientLine-Mastercard-AUD,,0,0,0,38617.02,38617.02,38617.02,140189546.78999996,140189546.78999996,ACH,AUD
2025-02-19,Settlement from ClientLine,Processor Payout Batch,SET-20250217-ClientLine-Mastercard-CAD,,0,0,0,47565.62,47565.62,47565.62,140237112.40999997,140237112.40999997,ACH,CAD
2025-02-19,Settlement from ClientLine,Processor Payout Batch,SET-20250217-ClientLine-Mastercard-EUR,,0,0,0,39580.49,39580.49,39580.49,140276692.89999998,140276692.89999998,ACH,EUR
2025-02-19,Settlement from ClientLine,Processor Payout Batch,SET-20250217-ClientLine-Mastercard-GBP,,0,0,0,20480.09,20480.09,20480.09,140297172.98999998,140297172.98999998,ACH,GBP
2025-02-19,Settlement from ClientLine,Processor Payout Batch,SET-20250217-ClientLine-Visa-AUD,,0,0,0,28698.3,28698.3,28698.3,140325871.29,140325871.29,ACH,AUD
2025-02-19,Settlement from GoCardless,Processor Payout Batch,SET-20250217-GoCardless-N/A-CAD,,0,0,0,54662.75,54662.75,54662.75,140380534.04,140380534.04,ACH,CAD
2025-02-19,Settlement from ClientLine,Processor Payout Batch,SET-20250217-ClientLine-Visa-EUR,,0,0,0,32232.74,32232.74,32232.74,140412766.78,140412766.78,ACH,EUR
2025-02-19,Settlement from ClientLine,Processor Payout Batch,SET-20250217-ClientLine-Visa-GBP,,0,0,0,37552.85,37552.85,37552.85,140450319.63,140450319.63,ACH,GBP
2025-02-19,Settlement from ClientLine,Processor Payout Batch,SET-20250217-ClientLine-Visa-USD,,0,0,0,203504.01,203504.01,203504.01,140653823.64,140653823.64,ACH,USD
2025-02-19,Settlement from GoCardless,Processor Payout Batch,SET-20250217-GoCardless-N/A-AUD,,0,0,0,46229.07,46229.07,46229.07,140700052.70999998,140700052.70999998,ACH,AUD
2025-02-19,Settlement from GoCardless,Processor Payout Batch,SET-20250217-GoCardless-N/A-EUR,,0,0,0,163125.39,163125.39,163125.39,140863178.09999996,140863178.09999996,ACH,EUR
2025-02-19,Settlement from GoCardless,Processor Payout Batch,SET-20250217-GoCardless-N/A-GBP,,0,0,0,134505.07,134505.07,134505.07,140997683.16999996,140997683.16999996,ACH,GBP
2025-02-19,Settlement from GoCardless,Processor Payout Batch,SET-20250217-GoCardless-N/A-USD,,0,0,0,606891.17,606891.17,606891.17,141604574.33999994,141604574.33999994,ACH,USD
2025-02-19,Settlement from PayPal,Processor Payout Batch,SET-20250217-PayPal-N/A-AUD,,0,0,0,80801.69,80801.69,80801.69,141685376.02999994,141685376.02999994,ACH,AUD
2025-02-19,Settlement from PayPal,Processor Payout Batch,SET-20250217-PayPal-N/A-CAD,,0,0,0,72865.2,72865.2,72865.2,141758241.22999993,141758241.22999993,ACH,CAD
2025-02-19,Settlement from PayPal,Processor Payout Batch,SET-20250217-PayPal-N/A-USD,,0,0,0,560951.94,560951.94,560951.94,142319193.16999993,142319193.16999993,ACH,USD
2025-02-19,Settlement from ClientLine,Processor Payout Batch,SET-20250217-ClientLine-Visa-CAD,,0,0,0,20274.72,20274.72,20274.72,142339467.88999993,142339467.88999993,ACH,CAD
2025-02-19,Settlement from PayPal,Processor Payout Batch,SET-20250215-PayPal-N/A-USD,,0,0,0,646127.4,646127.4,646127.4,142985595.28999993,142985595.28999993,ACH,USD
2025-02-19,Settlement from GoCardless,Processor Payout Batch,SET-20250215-GoCardless-N/A-GBP,,0,0,0,98189.84,98189.84,98189.84,143083785.12999994,143083785.12999994,ACH,GBP
2025-02-19,Settlement from PayPal,Processor Payout Batch,SET-20250215-PayPal-N/A-EUR,,0,0,0,149499.16,149499.16,149499.16,143233284.28999993,143233284.28999993,ACH,EUR
2025-02-19,Settlement from PayPal,Processor Payout Batch,SET-20250215-PayPal-N/A-AUD,,0,0,0,67999.33,67999.33,67999.33,143301283.61999995,143301283.61999995,ACH,AUD
2025-02-19,Settlement from GoCardless,Processor Payout Batch,SET-20250215-GoCardless-N/A-USD,,0,0,0,586424.43,586424.43,586424.43,143887708.04999995,143887708.04999995,ACH,USD
2025-02-19,Settlement from PayPal,Processor Payout Batch,SET-20250217-PayPal-N/A-EUR,,0,0,0,185831.52,185831.52,185831.52,144073539.56999996,144073539.56999996,ACH,EUR
2025-02-19,Settlement from GoCardless,Processor Payout Batch,SET-20250215-GoCardless-N/A-EUR,,0,0,0,160612.35,160612.35,160612.35,144234151.91999996,144234151.91999996,ACH,EUR
2025-02-19,Settlement from GoCardless,Processor Payout Batch,SET-20250215-GoCardless-N/A-CAD,,0,0,0,98498.61,98498.61,98498.61,144332650.52999997,144332650.52999997,ACH,CAD
2025-02-19,Settlement from GoCardless,Processor Payout Batch,SET-20250215-GoCardless-N/A-AUD,,0,0,0,80959.45,80959.45,80959.45,144413609.97999996,144413609.97999996,ACH,AUD
2025-02-19,Settlement from ClientLine,Processor Payout Batch,SET-20250215-ClientLine-Visa-USD,,0,0,0,213539.74,213539.74,213539.74,144627149.71999997,144627149.71999997,ACH,USD
2025-02-19,Settlement from ClientLine,Processor Payout Batch,SET-20250215-ClientLine-Visa-GBP,,0,0,0,35435.94,35435.94,35435.94,144662585.65999997,144662585.65999997,ACH,GBP
2025-02-19,Settlement from ClientLine,Processor Payout Batch,SET-20250215-ClientLine-Visa-EUR,,0,0,0,81426.52,81426.52,81426.52,144744012.17999998,144744012.17999998,ACH,EUR
2025-02-19,Settlement from ClientLine,Processor Payout Batch,SET-20250215-ClientLine-Visa-CAD,,0,0,0,16121.74,16121.74,16121.74,144760133.92,144760133.92,ACH,CAD
2025-02-19,Settlement from ClientLine,Processor Payout Batch,SET-20250215-ClientLine-Visa-AUD,,0,0,0,25697.38,25697.38,25697.38,144785831.29999998,144785831.29999998,ACH,AUD
2025-02-19,Settlement from ClientLine,Processor Payout Batch,SET-20250215-ClientLine-Mastercard-USD,,0,0,0,169696.95,169696.95,169696.95,144955528.24999997,144955528.24999997,ACH,USD
2025-02-19,Settlement from ClientLine,Processor Payout Batch,SET-20250215-ClientLine-Mastercard-GBP,,0,0,0,42684.54,42684.54,42684.54,144998212.78999996,144998212.78999996,ACH,GBP
2025-02-19,Settlement from ClientLine,Processor Payout Batch,SET-20250215-ClientLine-Mastercard-EUR,,0,0,0,32489.31,32489.31,32489.31,145030702.09999996,145030702.09999996,ACH,EUR
2025-02-19,Settlement from ClientLine,Processor Payout Batch,SET-20250215-ClientLine-Mastercard-CAD,,0,0,0,24256.99,24256.99,24256.99,145054959.08999997,145054959.08999997,ACH,CAD
2025-02-19,Settlement from ClientLine,Processor Payout Batch,SET-20250215-ClientLine-Mastercard-AUD,,0,0,0,38206.97,38206.97,38206.97,145093166.05999997,145093166.05999997,ACH,AUD
2025-02-19,Settlement from Amex,Processor Payout Batch,SET-20250215-Amex-Amex-USD,,0,0,0,217291.95,217291.95,217291.95,145310458.00999996,145310458.00999996,ACH,USD
2025-02-19,Settlement from Amex,Processor Payout Batch,SET-20250215-Amex-Amex-GBP,,0,0,0,34008.48,34008.48,34008.48,145344466.48999995,145344466.48999995,ACH,GBP
2025-02-19,Settlement from Amex,Processor Payout Batch,SET-20250215-Amex-Amex-EUR,,0,0,0,39537.9,39537.9,39537.9,145384004.38999996,145384004.38999996,ACH,EUR
2025-02-19,Settlement from Amex,Processor Payout Batch,SET-20250215-Amex-Amex-CAD,,0,0,0,25867.77,25867.77,25867.77,145409872.15999997,145409872.15999997,ACH,CAD
2025-02-19,Settlement from Amex,Processor Payout Batch,SET-20250215-Amex-Amex-AUD,,0,0,0,26770.89,26770.89,26770.89,145436643.04999995,145436643.04999995,ACH,AUD
2025-02-19,Settlement from PayPal,Processor Payout Batch,SET-20250215-PayPal-N/A-CAD,,0,0,0,95175.96,95175.96,95175.96,145531819.00999996,145531819.00999996,ACH,CAD
2025-02-19,Settlement from PayPal,Processor Payout Batch,SET-20250215-PayPal-N/A-GBP,,0,0,0,91065.72,91065.72,91065.72,145622884.72999996,145622884.72999996,ACH,GBP
2025-02-19,Settlement from PayPal,Processor Payout Batch,SET-20250217-PayPal-N/A-GBP,,0,0,0,99833.49,99833.49,99833.49,145722718.21999997,145722718.21999997,ACH,GBP
2025-02-20,Settlement from Amex,Processor Payout Batch,SET-20250218-Amex-Amex-CAD,,0,0,0,36881.15,36881.15,36881.15,145759599.36999997,145759599.36999997,ACH,CAD
2025-02-20,Settlement from PayPal,Processor Payout Batch,SET-20250218-PayPal-N/A-GBP,,0,0,0,108920.07,108920.07,108920.07,145868519.43999997,145868519.43999997,ACH,GBP
2025-02-20,Settlement from PayPal,Processor Payout Batch,SET-20250218-PayPal-N/A-EUR,,0,0,0,131240.29,131240.29,131240.29,145999759.72999996,145999759.72999996,ACH,EUR
2025-02-20,Settlement from PayPal,Processor Payout Batch,SET-20250218-PayPal-N/A-CAD,,0,0,0,79671.42,79671.42,79671.42,146079431.14999995,146079431.14999995,ACH,CAD
2025-02-20,Settlement from PayPal,Processor Payout Batch,SET-20250218-PayPal-N/A-AUD,,0,0,0,118436.59,118436.59,118436.59,146197867.73999995,146197867.73999995,ACH,AUD
2025-02-20,Settlement from GoCardless,Processor Payout Batch,SET-20250218-GoCardless-N/A-USD,,0,0,0,648504.4,648504.4,648504.4,146846372.13999996,146846372.13999996,ACH,USD
2025-02-20,Settlement from GoCardless,Processor Payout Batch,SET-20250218-GoCardless-N/A-GBP,,0,0,0,97541.23,97541.23,97541.23,146943913.36999995,146943913.36999995,ACH,GBP
2025-02-20,Settlement from GoCardless,Processor Payout Batch,SET-20250218-GoCardless-N/A-EUR,,0,0,0,155148.05,155148.05,155148.05,147099061.41999996,147099061.41999996,ACH,EUR
2025-02-20,Settlement from GoCardless,Processor Payout Batch,SET-20250218-GoCardless-N/A-CAD,,0,0,0,78059.7,78059.7,78059.7,147177121.11999995,147177121.11999995,ACH,CAD
2025-02-20,Settlement from GoCardless,Processor Payout Batch,SET-20250218-GoCardless-N/A-AUD,,0,0,0,93800.62,93800.62,93800.62,147270921.73999995,147270921.73999995,ACH,AUD
2025-02-20,Settlement from ClientLine,Processor Payout Batch,SET-20250218-ClientLine-Visa-USD,,0,0,0,190261.03,190261.03,190261.03,147461182.76999995,147461182.76999995,ACH,USD
2025-02-20,Settlement from ClientLine,Processor Payout Batch,SET-20250218-ClientLine-Visa-GBP,,0,0,0,51119.31,51119.31,51119.31,147512302.07999995,147512302.07999995,ACH,GBP
2025-02-20,Settlement from ClientLine,Processor Payout Batch,SET-20250218-ClientLine-Visa-EUR,,0,0,0,61118.78,61118.78,61118.78,147573420.85999995,147573420.85999995,ACH,EUR
2025-02-20,Settlement from ClientLine,Processor Payout Batch,SET-20250218-ClientLine-Visa-CAD,,0,0,0,25588.52,25588.52,25588.52,147599009.37999997,147599009.37999997,ACH,CAD
2025-02-20,Settlement from ClientLine,Processor Payout Batch,SET-20250218-ClientLine-Visa-AUD,,0,0,0,11896.62,11896.62,11896.62,147610905.99999997,147610905.99999997,ACH,AUD
2025-02-20,Settlement from ClientLine,Processor Payout Batch,SET-20250218-ClientLine-Mastercard-USD,,0,0,0,227189.82,227189.82,227189.82,147838095.81999996,147838095.81999996,ACH,USD
2025-02-20,Settlement from ClientLine,Processor Payout Batch,SET-20250218-ClientLine-Mastercard-GBP,,0,0,0,41764.84,41764.84,41764.84,147879860.65999997,147879860.65999997,ACH,GBP
2025-02-20,Settlement from ClientLine,Processor Payout Batch,SET-20250218-ClientLine-Mastercard-EUR,,0,0,0,62183.75,62183.75,62183.75,147942044.40999997,147942044.40999997,ACH,EUR
2025-02-20,Settlement from ClientLine,Processor Payout Batch,SET-20250218-ClientLine-Mastercard-CAD,,0,0,0,23728.12,23728.12,23728.12,147965772.52999997,147965772.52999997,ACH,CAD
2025-02-20,Settlement from Amex,Processor Payout Batch,SET-20250218-Amex-Amex-USD,,0,0,0,155911.72,155911.72,155911.72,148121684.24999997,148121684.24999997,ACH,USD
2025-02-20,Settlement from Amex,Processor Payout Batch,SET-20250218-Amex-Amex-GBP,,0,0,0,18591.65,18591.65,18591.65,148140275.89999998,148140275.89999998,ACH,GBP
2025-02-20,Settlement from Amex,Processor Payout Batch,SET-20250218-Amex-Amex-EUR,,0,0,0,43208.29,43208.29,43208.29,148183484.18999997,148183484.18999997,ACH,EUR
2025-02-20,Settlement from Amex,Processor Payout Batch,SET-20250218-Amex-Amex-AUD,,0,0,0,6105.74,6105.74,6105.74,148189589.92999998,148189589.92999998,ACH,AUD
2025-02-20,Settlement from PayPal,Processor Payout Batch,SET-20250218-PayPal-N/A-USD,,0,0,0,711543.33,711543.33,711543.33,148901133.26,148901133.26,ACH,USD
2025-02-20,Settlement from ClientLine,Processor Payout Batch,SET-20250218-ClientLine-Mastercard-AUD,,0,0,0,13446.14,13446.14,13446.14,148914579.39999998,148914579.39999998,ACH,AUD
2025-02-20,Settlement from PayPal,Processor Payout Batch,SET-20250216-PayPal-N/A-GBP,,0,0,0,120888.98,120888.98,120888.98,149035468.37999997,149035468.37999997,ACH,GBP
2025-02-20,Settlement from Amex,Processor Payout Batch,SET-20250216-Amex-Amex-AUD,,0,0,0,24790.74,24790.74,24790.74,149060259.11999997,149060259.11999997,ACH,AUD
2025-02-20,Settlement from Amex,Processor Payout Batch,SET-20250216-Amex-Amex-CAD,,0,0,0,24720.33,24720.33,24720.33,149084979.45,149084979.45,ACH,CAD
2025-02-20,Settlement from Amex,Processor Payout Batch,SET-20250216-Amex-Amex-EUR,,0,0,0,60220.35,60220.35,60220.35,149145199.79999998,149145199.79999998,ACH,EUR
2025-02-20,Settlement from Amex,Processor Payout Batch,SET-20250216-Amex-Amex-GBP,,0,0,0,31075.28,31075.28,31075.28,149176275.07999998,149176275.07999998,ACH,GBP
2025-02-20,Settlement from Amex,Processor Payout Batch,SET-20250216-Amex-Amex-USD,,0,0,0,249446.03,249446.03,249446.03,149425721.10999998,149425721.10999998,ACH,USD
2025-02-20,Settlement from ClientLine,Processor Payout Batch,SET-20250216-ClientLine-Mastercard-AUD,,0,0,0,32760.5,32760.5,32760.5,149458481.60999998,149458481.60999998,ACH,AUD
2025-02-20,Settlement from ClientLine,Processor Payout Batch,SET-20250216-ClientLine-Mastercard-CAD,,0,0,0,21205.32,21205.32,21205.32,149479686.92999998,149479686.92999998,ACH,CAD
2025-02-20,Settlement from ClientLine,Processor Payout Batch,SET-20250216-ClientLine-Mastercard-EUR,,0,0,0,35392.45,35392.45,35392.45,149515079.37999997,149515079.37999997,ACH,EUR
2025-02-20,Settlement from ClientLine,Processor Payout Batch,SET-20250216-ClientLine-Mastercard-GBP,,0,0,0,36741.54,36741.54,36741.54,149551820.91999996,149551820.91999996,ACH,GBP
2025-02-20,Settlement from ClientLine,Processor Payout Batch,SET-20250216-ClientLine-Mastercard-USD,,0,0,0,151349.16,151349.16,151349.16,149703170.07999995,149703170.07999995,ACH,USD
2025-02-20,Settlement from ClientLine,Processor Payout Batch,SET-20250216-ClientLine-Visa-AUD,,0,0,0,29501.27,29501.27,29501.27,149732671.34999996,149732671.34999996,ACH,AUD
2025-02-20,Settlement from ClientLine,Processor Payout Batch,SET-20250216-ClientLine-Visa-CAD,,0,0,0,9043.89,9043.89,9043.89,149741715.23999995,149741715.23999995,ACH,CAD
2025-02-20,Settlement from PayPal,Processor Payout Batch,SET-20250216-PayPal-N/A-USD,,0,0,0,610144.81,610144.81,610144.81,150351860.04999995,150351860.04999995,ACH,USD
2025-02-20,Settlement from ClientLine,Processor Payout Batch,SET-20250216-ClientLine-Visa-GBP,,0,0,0,60733.1,60733.1,60733.1,150412593.14999995,150412593.14999995,ACH,GBP
2025-02-20,Settlement from PayPal,Processor Payout Batch,SET-20250216-PayPal-N/A-EUR,,0,0,0,133673.21,133673.21,133673.21,150546266.35999995,150546266.35999995,ACH,EUR
2025-02-20,Settlement from PayPal,Processor Payout Batch,SET-20250216-PayPal-N/A-CAD,,0,0,0,90813.41,90813.41,90813.41,150637079.76999995,150637079.76999995,ACH,CAD
2025-02-20,Settlement from PayPal,Processor Payout Batch,SET-20250216-PayPal-N/A-AUD,,0,0,0,86612.0,86612.0,86612.0,150723691.76999995,150723691.76999995,ACH,AUD
2025-02-20,Settlement from GoCardless,Processor Payout Batch,SET-20250216-GoCardless-N/A-USD,,0,0,0,653367.64,653367.64,653367.64,151377059.40999994,151377059.40999994,ACH,USD
2025-02-20,Settlement from ClientLine,Processor Payout Batch,SET-20250216-ClientLine-Visa-EUR,,0,0,0,52696.97,52696.97,52696.97,151429756.37999994,151429756.37999994,ACH,EUR
2025-02-20,Settlement from GoCardless,Processor Payout Batch,SET-20250216-GoCardless-N/A-EUR,,0,0,0,150661.43,150661.43,150661.43,151580417.80999994,151580417.80999994,ACH,EUR
2025-02-20,Settlement from GoCardless,Processor Payout Batch,SET-20250216-GoCardless-N/A-CAD,,0,0,0,85642.63,85642.63,85642.63,151666060.43999994,151666060.43999994,ACH,CAD
2025-02-20,Settlement from GoCardless,Processor Payout Batch,SET-20250216-GoCardless-N/A-AUD,,0,0,0,90664.52,90664.52,90664.52,151756724.95999995,151756724.95999995,ACH,AUD
2025-02-20,Settlement from ClientLine,Processor Payout Batch,SET-20250216-ClientLine-Visa-USD,,0,0,0,209580.63,209580.63,209580.63,151966305.58999994,151966305.58999994,ACH,USD
2025-02-20,Settlement from GoCardless,Processor Payout Batch,SET-20250216-GoCardless-N/A-GBP,,0,0,0,76308.69,76308.69,76308.69,152042614.27999994,152042614.27999994,ACH,GBP
2025-02-21,Settlement from PayPal,Processor Payout Batch,SET-20250219-PayPal-N/A-USD,,0,0,0,579087.07,579087.07,579087.07,152621701.34999993,152621701.34999993,ACH,USD
2025-02-21,Settlement from ClientLine,Processor Payout Batch,SET-20250219-ClientLine-Visa-USD,,0,0,0,239777.47,239777.47,239777.47,152861478.81999993,152861478.81999993,ACH,USD
2025-02-21,Settlement from GoCardless,Processor Payout Batch,SET-20250219-GoCardless-N/A-AUD,,0,0,0,92373.57,92373.57,92373.57,152953852.38999993,152953852.38999993,ACH,AUD
2025-02-21,Settlement from GoCardless,Processor Payout Batch,SET-20250219-GoCardless-N/A-CAD,,0,0,0,45149.32,45149.32,45149.32,152999001.70999992,152999001.70999992,ACH,CAD
2025-02-21,Settlement from GoCardless,Processor Payout Batch,SET-20250219-GoCardless-N/A-EUR,,0,0,0,174564.72,174564.72,174564.72,153173566.42999992,153173566.42999992,ACH,EUR
2025-02-21,Settlement from PayPal,Processor Payout Batch,SET-20250219-PayPal-N/A-AUD,,0,0,0,70069.01,70069.01,70069.01,153243635.4399999,153243635.4399999,ACH,AUD
2025-02-21,Settlement from GoCardless,Processor Payout Batch,SET-20250219-GoCardless-N/A-USD,,0,0,0,639342.2,639342.2,639342.2,153882977.6399999,153882977.6399999,ACH,USD
2025-02-21,Settlement from PayPal,Processor Payout Batch,SET-20250219-PayPal-N/A-CAD,,0,0,0,84359.17,84359.17,84359.17,153967336.80999988,153967336.80999988,ACH,CAD
2025-02-21,Settlement from PayPal,Processor Payout Batch,SET-20250219-PayPal-N/A-EUR,,0,0,0,192470.02,192470.02,192470.02,154159806.8299999,154159806.8299999,ACH,EUR
2025-02-21,Settlement from ClientLine,Processor Payout Batch,SET-20250219-ClientLine-Visa-GBP,,0,0,0,31393.66,31393.66,31393.66,154191200.4899999,154191200.4899999,ACH,GBP
2025-02-21,Settlement from GoCardless,Processor Payout Batch,SET-20250219-GoCardless-N/A-GBP,,0,0,0,127952.78,127952.78,127952.78,154319153.2699999,154319153.2699999,ACH,GBP
2025-02-21,Settlement from PayPal,Processor Payout Batch,SET-20250219-PayPal-N/A-GBP,,0,0,0,86935.58,86935.58,86935.58,154406088.8499999,154406088.8499999,ACH,GBP
2025-02-21,Settlement from ClientLine,Processor Payout Batch,SET-20250219-ClientLine-Visa-EUR,,0,0,0,50648.54,50648.54,50648.54,154456737.3899999,154456737.3899999,ACH,EUR
2025-02-21,Settlement from ClientLine,Processor Payout Batch,SET-20250219-ClientLine-Visa-AUD,,0,0,0,32605.92,32605.92,32605.92,154489343.30999988,154489343.30999988,ACH,AUD
2025-02-21,Settlement from ClientLine,Processor Payout Batch,SET-20250219-ClientLine-Visa-CAD,,0,0,0,25091.72,25091.72,25091.72,154514435.02999988,154514435.02999988,ACH,CAD
2025-02-21,Settlement from Amex,Processor Payout Batch,SET-20250219-Amex-Amex-AUD,,0,0,0,28403.1,28403.1,28403.1,154542838.12999988,154542838.12999988,ACH,AUD
2025-02-21,Settlement from Amex,Processor Payout Batch,SET-20250219-Amex-Amex-CAD,,0,0,0,9350.19,9350.19,9350.19,154552188.31999987,154552188.31999987,ACH,CAD
2025-02-21,Settlement from Amex,Processor Payout Batch,SET-20250219-Amex-Amex-EUR,,0,0,0,54254.58,54254.58,54254.58,154606442.8999999,154606442.8999999,ACH,EUR
2025-02-21,Settlement from Amex,Processor Payout Batch,SET-20250219-Amex-Amex-GBP,,0,0,0,47273.5,47273.5,47273.5,154653716.3999999,154653716.3999999,ACH,GBP
2025-02-21,Settlement from ClientLine,Processor Payout Batch,SET-20250219-ClientLine-Mastercard-AUD,,0,0,0,27752.03,27752.03,27752.03,154681468.4299999,154681468.4299999,ACH,AUD
2025-02-21,Settlement from ClientLine,Processor Payout Batch,SET-20250219-ClientLine-Mastercard-CAD,,0,0,0,25290.53,25290.53,25290.53,154706758.9599999,154706758.9599999,ACH,CAD
2025-02-21,Settlement from ClientLine,Processor Payout Batch,SET-20250219-ClientLine-Mastercard-EUR,,0,0,0,45995.68,45995.68,45995.68,154752754.6399999,154752754.6399999,ACH,EUR
2025-02-21,Settlement from ClientLine,Processor Payout Batch,SET-20250219-ClientLine-Mastercard-GBP,,0,0,0,28267.08,28267.08,28267.08,154781021.7199999,154781021.7199999,ACH,GBP
2025-02-21,Settlement from ClientLine,Processor Payout Batch,SET-20250219-ClientLine-Mastercard-USD,,0,0,0,224747.12,224747.12,224747.12,155005768.8399999,155005768.8399999,ACH,USD
2025-02-21,Settlement from Amex,Processor Payout Batch,SET-20250219-Amex-Amex-USD,,0,0,0,237902.84,237902.84,237902.84,155243671.67999992,155243671.67999992,ACH,USD
2025-02-24,Settlement from ClientLine,Processor Payout Batch,SET-20250220-ClientLine-Visa-GBP,,0,0,0,25444.52,25444.52,25444.52,155269116.19999993,155269116.19999993,ACH,GBP
2025-02-24,Settlement from ClientLine,Processor Payout Batch,SET-20250220-ClientLine-Visa-USD,,0,0,0,165202.84,165202.84,165202.84,155434319.03999993,155434319.03999993,ACH,USD
2025-02-24,Settlement from GoCardless,Processor Payout Batch,SET-20250220-GoCardless-N/A-AUD,,0,0,0,68713.14,68713.14,68713.14,155503032.17999992,155503032.17999992,ACH,AUD
2025-02-24,Settlement from GoCardless,Processor Payout Batch,SET-20250220-GoCardless-N/A-CAD,,0,0,0,103865.87,103865.87,103865.87,155606898.04999992,155606898.04999992,ACH,CAD
2025-02-24,Settlement from GoCardless,Processor Payout Batch,SET-20250220-GoCardless-N/A-EUR,,0,0,0,142927.18,142927.18,142927.18,155749825.22999993,155749825.22999993,ACH,EUR
2025-02-24,Settlement from PayPal,Processor Payout Batch,SET-20250220-PayPal-N/A-AUD,,0,0,0,75139.5,75139.5,75139.5,155824964.72999993,155824964.72999993,ACH,AUD
2025-02-24,Settlement from GoCardless,Processor Payout Batch,SET-20250220-GoCardless-N/A-USD,,0,0,0,625656.5,625656.5,625656.5,156450621.22999993,156450621.22999993,ACH,USD
2025-02-24,Settlement from PayPal,Processor Payout Batch,SET-20250220-PayPal-N/A-CAD,,0,0,0,56386.76,56386.76,56386.76,156507007.98999992,156507007.98999992,ACH,CAD
2025-02-24,Settlement from PayPal,Processor Payout Batch,SET-20250220-PayPal-N/A-EUR,,0,0,0,188924.51,188924.51,188924.51,156695932.4999999,156695932.4999999,ACH,EUR
2025-02-24,Settlement from PayPal,Processor Payout Batch,SET-20250220-PayPal-N/A-GBP,,0,0,0,98109.98,98109.98,98109.98,156794042.4799999,156794042.4799999,ACH,GBP
2025-02-24,Settlement from GoCardless,Processor Payout Batch,SET-20250220-GoCardless-N/A-GBP,,0,0,0,71271.86,71271.86,71271.86,156865314.3399999,156865314.3399999,ACH,GBP
2025-02-24,Settlement from PayPal,Processor Payout Batch,SET-20250220-PayPal-N/A-USD,,0,0,0,615430.28,615430.28,615430.28,157480744.61999992,157480744.61999992,ACH,USD
2025-02-24,Settlement from ClientLine,Processor Payout Batch,SET-20250220-ClientLine-Visa-CAD,,0,0,0,25679.59,25679.59,25679.59,157506424.20999992,157506424.20999992,ACH,CAD
2025-02-24,Settlement from ClientLine,Processor Payout Batch,SET-20250220-ClientLine-Visa-AUD,,0,0,0,17812.97,17812.97,17812.97,157524237.17999992,157524237.17999992,ACH,AUD
2025-02-24,Settlement from ClientLine,Processor Payout Batch,SET-20250220-ClientLine-Mastercard-USD,,0,0,0,176736.07,176736.07,176736.07,157700973.2499999,157700973.2499999,ACH,USD
2025-02-24,Settlement from ClientLine,Processor Payout Batch,SET-20250220-ClientLine-Mastercard-GBP,,0,0,0,41924.1,41924.1,41924.1,157742897.3499999,157742897.3499999,ACH,GBP
2025-02-24,Settlement from ClientLine,Processor Payout Batch,SET-20250220-ClientLine-Mastercard-EUR,,0,0,0,71078.64,71078.64,71078.64,157813975.9899999,157813975.9899999,ACH,EUR
2025-02-24,Settlement from ClientLine,Processor Payout Batch,SET-20250220-ClientLine-Mastercard-CAD,,0,0,0,48626.06,48626.06,48626.06,157862602.0499999,157862602.0499999,ACH,CAD
2025-02-24,Settlement from ClientLine,Processor Payout Batch,SET-20250220-ClientLine-Mastercard-AUD,,0,0,0,30815.37,30815.37,30815.37,157893417.4199999,157893417.4199999,ACH,AUD
2025-02-24,Settlement from Amex,Processor Payout Batch,SET-20250220-Amex-Amex-USD,,0,0,0,174833.34,174833.34,174833.34,158068250.7599999,158068250.7599999,ACH,USD
2025-02-24,Settlement from Amex,Processor Payout Batch,SET-20250220-Amex-Amex-GBP,,0,0,0,42523.46,42523.46,42523.46,158110774.2199999,158110774.2199999,ACH,GBP
2025-02-24,Settlement from Amex,Processor Payout Batch,SET-20250220-Amex-Amex-EUR,,0,0,0,43015.7,43015.7,43015.7,158153789.9199999,158153789.9199999,ACH,EUR
2025-02-24,Settlement from Amex,Processor Payout Batch,SET-20250220-Amex-Amex-CAD,,0,0,0,27956.23,27956.23,27956.23,158181746.1499999,158181746.1499999,ACH,CAD
2025-02-24,Settlement from Amex,Processor Payout Batch,SET-20250220-Amex-Amex-AUD,,0,0,0,42384.52,42384.52,42384.52,158224130.6699999,158224130.6699999,ACH,AUD
2025-02-24,Settlement from ClientLine,Processor Payout Batch,SET-20250220-ClientLine-Visa-EUR,,0,0,0,55328.6,55328.6,55328.6,158279459.2699999,158279459.2699999,ACH,EUR
2025-02-25,Settlement from ClientLine,Processor Payout Batch,SET-20250221-ClientLine-Visa-USD,,0,0,0,156492.2,156492.2,156492.2,158435951.46999988,158435951.46999988,ACH,USD
2025-02-25,Settlement from GoCardless,Processor Payout Batch,SET-20250221-GoCardless-N/A-AUD,,0,0,0,69969.48,69969.48,69969.48,158505920.94999987,158505920.94999987,ACH,AUD
2025-02-25,Settlement from GoCardless,Processor Payout Batch,SET-20250221-GoCardless-N/A-CAD,,0,0,0,89131.68,89131.68,89131.68,158595052.62999988,158595052.62999988,ACH,CAD
2025-02-25,Settlement from GoCardless,Processor Payout Batch,SET-20250221-GoCardless-N/A-EUR,,0,0,0,148443.09,148443.09,148443.09,158743495.71999988,158743495.71999988,ACH,EUR
2025-02-25,Settlement from PayPal,Processor Payout Batch,SET-20250221-PayPal-N/A-USD,,0,0,0,642996.18,642996.18,642996.18,159386491.8999999,159386491.8999999,ACH,USD
2025-02-25,Settlement from PayPal,Processor Payout Batch,SET-20250221-PayPal-N/A-AUD,,0,0,0,96597.35,96597.35,96597.35,159483089.24999988,159483089.24999988,ACH,AUD
2025-02-25,Settlement from PayPal,Processor Payout Batch,SET-20250221-PayPal-N/A-CAD,,0,0,0,88500.59,88500.59,88500.59,159571589.83999988,159571589.83999988,ACH,CAD
2025-02-25,Settlement from PayPal,Processor Payout Batch,SET-20250221-PayPal-N/A-EUR,,0,0,0,166660.68,166660.68,166660.68,159738250.5199999,159738250.5199999,ACH,EUR
2025-02-25,Settlement from PayPal,Processor Payout Batch,SET-20250221-PayPal-N/A-GBP,,0,0,0,92024.4,92024.4,92024.4,159830274.9199999,159830274.9199999,ACH,GBP
2025-02-25,Settlement from ClientLine,Processor Payout Batch,SET-20250221-ClientLine-Visa-GBP,,0,0,0,18368.71,18368.71,18368.71,159848643.6299999,159848643.6299999,ACH,GBP
2025-02-25,Settlement from GoCardless,Processor Payout Batch,SET-20250221-GoCardless-N/A-USD,,0,0,0,655334.98,655334.98,655334.98,160503978.6099999,160503978.6099999,ACH,USD
2025-02-25,Settlement from ClientLine,Processor Payout Batch,SET-20250221-ClientLine-Visa-EUR,,0,0,0,67012.95,67012.95,67012.95,160570991.55999988,160570991.55999988,ACH,EUR
2025-02-25,Settlement from GoCardless,Processor Payout Batch,SET-20250221-GoCardless-N/A-GBP,,0,0,0,111334.08,111334.08,111334.08,160682325.6399999,160682325.6399999,ACH,GBP
2025-02-25,Settlement from ClientLine,Processor Payout Batch,SET-20250221-ClientLine-Visa-AUD,,0,0,0,20921.82,20921.82,20921.82,160703247.4599999,160703247.4599999,ACH,AUD
2025-02-25,Settlement from ClientLine,Processor Payout Batch,SET-20250221-ClientLine-Mastercard-USD,,0,0,0,202992.78,202992.78,202992.78,160906240.2399999,160906240.2399999,ACH,USD
2025-02-25,Settlement from ClientLine,Processor Payout Batch,SET-20250221-ClientLine-Mastercard-GBP,,0,0,0,32389.07,32389.07,32389.07,160938629.30999988,160938629.30999988,ACH,GBP
2025-02-25,Settlement from ClientLine,Processor Payout Batch,SET-20250221-ClientLine-Mastercard-EUR,,0,0,0,55865.85,55865.85,55865.85,160994495.15999988,160994495.15999988,ACH,EUR
2025-02-25,Settlement from ClientLine,Processor Payout Batch,SET-20250221-ClientLine-Mastercard-CAD,,0,0,0,17713.91,17713.91,17713.91,161012209.06999987,161012209.06999987,ACH,CAD
2025-02-25,Settlement from ClientLine,Processor Payout Batch,SET-20250221-ClientLine-Mastercard-AUD,,0,0,0,40277.91,40277.91,40277.91,161052486.97999987,161052486.97999987,ACH,AUD
2025-02-25,Settlement from Amex,Processor Payout Batch,SET-20250221-Amex-Amex-USD,,0,0,0,244823.21,244823.21,244823.21,161297310.18999988,161297310.18999988,ACH,USD
2025-02-25,Settlement from Amex,Processor Payout Batch,SET-20250221-Amex-Amex-GBP,,0,0,0,31443.84,31443.84,31443.84,161328754.02999988,161328754.02999988,ACH,GBP
2025-02-25,Settlement from Amex,Processor Payout Batch,SET-20250221-Amex-Amex-EUR,,0,0,0,46225.99,46225.99,46225.99,161374980.0199999,161374980.0199999,ACH,EUR
2025-02-25,Settlement from Amex,Processor Payout Batch,SET-20250221-Amex-Amex-CAD,,0,0,0,26997.58,26997.58,26997.58,161401977.5999999,161401977.5999999,ACH,CAD
2025-02-25,Settlement from Amex,Processor Payout Batch,SET-20250221-Amex-Amex-AUD,,0,0,0,44280.25,44280.25,44280.25,161446257.8499999,161446257.8499999,ACH,AUD
2025-02-25,Settlement from ClientLine,Processor Payout Batch,SET-20250221-ClientLine-Visa-CAD,,0,0,0,24703.3,24703.3,24703.3,161470961.14999992,161470961.14999992,ACH,CAD
2025-02-26,Settlement from ClientLine,Processor Payout Batch,SET-20250224-ClientLine-Visa-AUD,,0,0,0,13202.88,13202.88,13202.88,161484164.0299999,161484164.0299999,ACH,AUD
2025-02-26,Settlement from ClientLine,Processor Payout Batch,SET-20250224-ClientLine-Mastercard-USD,,0,0,0,190733.44,190733.44,190733.44,161674897.4699999,161674897.4699999,ACH,USD
2025-02-26,Settlement from ClientLine,Processor Payout Batch,SET-20250224-ClientLine-Mastercard-GBP,,0,0,0,29294.75,29294.75,29294.75,161704192.2199999,161704192.2199999,ACH,GBP
2025-02-26,Settlement from ClientLine,Processor Payout Batch,SET-20250224-ClientLine-Mastercard-EUR,,0,0,0,42274.69,42274.69,42274.69,161746466.9099999,161746466.9099999,ACH,EUR
2025-02-26,Settlement from Amex,Processor Payout Batch,SET-20250224-Amex-Amex-EUR,,0,0,0,40123.03,40123.03,40123.03,161786589.9399999,161786589.9399999,ACH,EUR
2025-02-26,Settlement from ClientLine,Processor Payout Batch,SET-20250224-ClientLine-Mastercard-AUD,,0,0,0,18521.89,18521.89,18521.89,161805111.8299999,161805111.8299999,ACH,AUD
2025-02-26,Settlement from Amex,Processor Payout Batch,SET-20250224-Amex-Amex-USD,,0,0,0,154768.03,154768.03,154768.03,161959879.8599999,161959879.8599999,ACH,USD
2025-02-26,Settlement from Amex,Processor Payout Batch,SET-20250224-Amex-Amex-GBP,,0,0,0,15856.07,15856.07,15856.07,161975735.9299999,161975735.9299999,ACH,GBP
2025-02-26,Settlement from ClientLine,Processor Payout Batch,SET-20250224-ClientLine-Visa-CAD,,0,0,0,18155.71,18155.71,18155.71,161993891.6399999,161993891.6399999,ACH,CAD
2025-02-26,Settlement from ClientLine,Processor Payout Batch,SET-20250224-ClientLine-Mastercard-CAD,,0,0,0,22197.85,22197.85,22197.85,162016089.4899999,162016089.4899999,ACH,CAD
2025-02-26,Settlement from ClientLine,Processor Payout Batch,SET-20250224-ClientLine-Visa-GBP,,0,0,0,40079.98,40079.98,40079.98,162056169.46999988,162056169.46999988,ACH,GBP
2025-02-26,Settlement from GoCardless,Processor Payout Batch,SET-20250224-GoCardless-N/A-USD,,0,0,0,546675.44,546675.44,546675.44,162602844.90999988,162602844.90999988,ACH,USD
2025-02-26,Settlement from GoCardless,Processor Payout Batch,SET-20250224-GoCardless-N/A-AUD,,0,0,0,88398.56,88398.56,88398.56,162691243.46999988,162691243.46999988,ACH,AUD
2025-02-26,Settlement from GoCardless,Processor Payout Batch,SET-20250224-GoCardless-N/A-CAD,,0,0,0,71421.52,71421.52,71421.52,162762664.9899999,162762664.9899999,ACH,CAD
2025-02-26,Settlement from GoCardless,Processor Payout Batch,SET-20250224-GoCardless-N/A-EUR,,0,0,0,161865.39,161865.39,161865.39,162924530.37999988,162924530.37999988,ACH,EUR
2025-02-26,Settlement from GoCardless,Processor Payout Batch,SET-20250224-GoCardless-N/A-GBP,,0,0,0,108918.51,108918.51,108918.51,163033448.88999987,163033448.88999987,ACH,GBP
2025-02-26,Settlement from PayPal,Processor Payout Batch,SET-20250224-PayPal-N/A-AUD,,0,0,0,84994.03,84994.03,84994.03,163118442.91999987,163118442.91999987,ACH,AUD
2025-02-26,Settlement from PayPal,Processor Payout Batch,SET-20250224-PayPal-N/A-CAD,,0,0,0,87036.01,87036.01,87036.01,163205478.92999986,163205478.92999986,ACH,CAD
2025-02-26,Settlement from PayPal,Processor Payout Batch,SET-20250224-PayPal-N/A-EUR,,0,0,0,194214.44,194214.44,194214.44,163399693.36999986,163399693.36999986,ACH,EUR
2025-02-26,Settlement from PayPal,Processor Payout Batch,SET-20250224-PayPal-N/A-GBP,,0,0,0,132725.49,132725.49,132725.49,163532418.85999987,163532418.85999987,ACH,GBP
2025-02-26,Settlement from PayPal,Processor Payout Batch,SET-20250224-PayPal-N/A-USD,,0,0,0,604110.92,604110.92,604110.92,164136529.77999985,164136529.77999985,ACH,USD
2025-02-26,Settlement from Amex,Processor Payout Batch,SET-20250224-Amex-Amex-CAD,,0,0,0,20414.5,20414.5,20414.5,164156944.27999985,164156944.27999985,ACH,CAD
2025-02-26,Settlement from ClientLine,Processor Payout Batch,SET-20250224-ClientLine-Visa-USD,,0,0,0,177474.8,177474.8,177474.8,164334419.07999986,164334419.07999986,ACH,USD
2025-02-26,Settlement from Amex,Processor Payout Batch,SET-20250224-Amex-Amex-AUD,,0,0,0,32769.72,32769.72,32769.72,164367188.79999986,164367188.79999986,ACH,AUD
2025-02-26,Settlement from ClientLine,Processor Payout Batch,SET-20250224-ClientLine-Visa-EUR,,0,0,0,48948.2,48948.2,48948.2,164416136.99999985,164416136.99999985,ACH,EUR
2025-02-26,Settlement from ClientLine,Processor Payout Batch,SET-20250222-ClientLine-Mastercard-CAD,,0,0,0,20286.78,20286.78,20286.78,164436423.77999985,164436423.77999985,ACH,CAD
2025-02-26,Settlement from PayPal,Processor Payout Batch,SET-20250222-PayPal-N/A-EUR,,0,0,0,167272.18,167272.18,167272.18,164603695.95999986,164603695.95999986,ACH,EUR
2025-02-26,Settlement from PayPal,Processor Payout Batch,SET-20250222-PayPal-N/A-CAD,,0,0,0,83860.86,83860.86,83860.86,164687556.81999987,164687556.81999987,ACH,CAD
2025-02-26,Settlement from PayPal,Processor Payout Batch,SET-20250222-PayPal-N/A-AUD,,0,0,0,52711.97,52711.97,52711.97,164740268.78999987,164740268.78999987,ACH,AUD
2025-02-26,Settlement from GoCardless,Processor Payout Batch,SET-20250222-GoCardless-N/A-USD,,0,0,0,611884.5,611884.5,611884.5,165352153.28999987,165352153.28999987,ACH,USD
2025-02-26,Settlement from GoCardless,Processor Payout Batch,SET-20250222-GoCardless-N/A-GBP,,0,0,0,112339.22,112339.22,112339.22,165464492.50999987,165464492.50999987,ACH,GBP
2025-02-26,Settlement from GoCardless,Processor Payout Batch,SET-20250222-GoCardless-N/A-EUR,,0,0,0,129679.25,129679.25,129679.25,165594171.75999987,165594171.75999987,ACH,EUR
2025-02-26,Settlement from GoCardless,Processor Payout Batch,SET-20250222-GoCardless-N/A-CAD,,0,0,0,79550.11,79550.11,79550.11,165673721.8699999,165673721.8699999,ACH,CAD
2025-02-26,Settlement from GoCardless,Processor Payout Batch,SET-20250222-GoCardless-N/A-AUD,,0,0,0,80140.43,80140.43,80140.43,165753862.2999999,165753862.2999999,ACH,AUD
2025-02-26,Settlement from ClientLine,Processor Payout Batch,SET-20250222-ClientLine-Visa-USD,,0,0,0,249038.2,249038.2,249038.2,166002900.49999988,166002900.49999988,ACH,USD
2025-02-26,Settlement from ClientLine,Processor Payout Batch,SET-20250222-ClientLine-Visa-GBP,,0,0,0,20742.8,20742.8,20742.8,166023643.2999999,166023643.2999999,ACH,GBP
2025-02-26,Settlement from ClientLine,Processor Payout Batch,SET-20250222-ClientLine-Visa-EUR,,0,0,0,37339.99,37339.99,37339.99,166060983.2899999,166060983.2899999,ACH,EUR
2025-02-26,Settlement from PayPal,Processor Payout Batch,SET-20250222-PayPal-N/A-USD,,0,0,0,583284.87,583284.87,583284.87,166644268.1599999,166644268.1599999,ACH,USD
2025-02-26,Settlement from ClientLine,Processor Payout Batch,SET-20250222-ClientLine-Visa-CAD,,0,0,0,13740.54,13740.54,13740.54,166658008.6999999,166658008.6999999,ACH,CAD
2025-02-26,Settlement from ClientLine,Processor Payout Batch,SET-20250222-ClientLine-Visa-AUD,,0,0,0,14505.67,14505.67,14505.67,166672514.3699999,166672514.3699999,ACH,AUD
2025-02-26,Settlement from ClientLine,Processor Payout Batch,SET-20250222-ClientLine-Mastercard-USD,,0,0,0,215963.51,215963.51,215963.51,166888477.87999988,166888477.87999988,ACH,USD
2025-02-26,Settlement from ClientLine,Processor Payout Batch,SET-20250222-ClientLine-Mastercard-GBP,,0,0,0,33417.72,33417.72,33417.72,166921895.59999987,166921895.59999987,ACH,GBP
2025-02-26,Settlement from ClientLine,Processor Payout Batch,SET-20250222-ClientLine-Mastercard-EUR,,0,0,0,36307.87,36307.87,36307.87,166958203.46999988,166958203.46999988,ACH,EUR
2025-02-26,Settlement from ClientLine,Processor Payout Batch,SET-20250222-ClientLine-Mastercard-AUD,,0,0,0,28884.27,28884.27,28884.27,166987087.7399999,166987087.7399999,ACH,AUD
2025-02-26,Settlement from Amex,Processor Payout Batch,SET-20250222-Amex-Amex-USD,,0,0,0,217406.57,217406.57,217406.57,167204494.30999988,167204494.30999988,ACH,USD
2025-02-26,Settlement from Amex,Processor Payout Batch,SET-20250222-Amex-Amex-GBP,,0,0,0,25972.97,25972.97,25972.97,167230467.27999988,167230467.27999988,ACH,GBP
2025-02-26,Settlement from Amex,Processor Payout Batch,SET-20250222-Amex-Amex-EUR,,0,0,0,39588.67,39588.67,39588.67,167270055.94999987,167270055.94999987,ACH,EUR
2025-02-26,Settlement from PayPal,Processor Payout Batch,SET-20250222-PayPal-N/A-GBP,,0,0,0,99352.7,99352.7,99352.7,167369408.64999986,167369408.64999986,ACH,GBP
2025-02-26,Settlement from Amex,Processor Payout Batch,SET-20250222-Amex-Amex-CAD,,0,0,0,15563.48,15563.48,15563.48,167384972.12999985,167384972.12999985,ACH,CAD
2025-02-26,Settlement from Amex,Processor Payout Batch,SET-20250222-Amex-Amex-AUD,,0,0,0,19967.68,19967.68,19967.68,167404939.80999985,167404939.80999985,ACH,AUD
2025-02-27,Settlement from Amex,Processor Payout Batch,SET-20250225-Amex-Amex-GBP,,0,0,0,23515.17,23515.17,23515.17,167428454.97999984,167428454.97999984,ACH,GBP
2025-02-27,Settlement from PayPal,Processor Payout Batch,SET-20250225-PayPal-N/A-USD,,0,0,0,580913.22,580913.22,580913.22,168009368.19999984,168009368.19999984,ACH,USD
2025-02-27,Settlement from PayPal,Processor Payout Batch,SET-20250225-PayPal-N/A-GBP,,0,0,0,103370.14,103370.14,103370.14,168112738.33999982,168112738.33999982,ACH,GBP
2025-02-27,Settlement from PayPal,Processor Payout Batch,SET-20250225-PayPal-N/A-EUR,,0,0,0,168574.09,168574.09,168574.09,168281312.42999983,168281312.42999983,ACH,EUR
2025-02-27,Settlement from PayPal,Processor Payout Batch,SET-20250225-PayPal-N/A-CAD,,0,0,0,74530.45,74530.45,74530.45,168355842.87999982,168355842.87999982,ACH,CAD
2025-02-27,Settlement from Amex,Processor Payout Batch,SET-20250225-Amex-Amex-AUD,,0,0,0,39096.22,39096.22,39096.22,168394939.09999982,168394939.09999982,ACH,AUD
2025-02-27,Settlement from PayPal,Processor Payout Batch,SET-20250225-PayPal-N/A-AUD,,0,0,0,118756.72,118756.72,118756.72,168513695.8199998,168513695.8199998,ACH,AUD
2025-02-27,Settlement from GoCardless,Processor Payout Batch,SET-20250225-GoCardless-N/A-USD,,0,0,0,648863.49,648863.49,648863.49,169162559.30999982,169162559.30999982,ACH,USD
2025-02-27,Settlement from GoCardless,Processor Payout Batch,SET-20250225-GoCardless-N/A-GBP,,0,0,0,123394.61,123394.61,123394.61,169285953.91999984,169285953.91999984,ACH,GBP
2025-02-27,Settlement from GoCardless,Processor Payout Batch,SET-20250225-GoCardless-N/A-EUR,,0,0,0,138916.32,138916.32,138916.32,169424870.23999983,169424870.23999983,ACH,EUR
2025-02-27,Settlement from GoCardless,Processor Payout Batch,SET-20250225-GoCardless-N/A-CAD,,0,0,0,81362.98,81362.98,81362.98,169506233.21999982,169506233.21999982,ACH,CAD
2025-02-27,Settlement from Amex,Processor Payout Batch,SET-20250225-Amex-Amex-EUR,,0,0,0,34528.38,34528.38,34528.38,169540761.59999982,169540761.59999982,ACH,EUR
2025-02-27,Settlement from GoCardless,Processor Payout Batch,SET-20250225-GoCardless-N/A-AUD,,0,0,0,115212.22,115212.22,115212.22,169655973.8199998,169655973.8199998,ACH,AUD
2025-02-27,Settlement from ClientLine,Processor Payout Batch,SET-20250225-ClientLine-Visa-GBP,,0,0,0,18985.61,18985.61,18985.61,169674959.42999983,169674959.42999983,ACH,GBP
2025-02-27,Settlement from ClientLine,Processor Payout Batch,SET-20250225-ClientLine-Visa-EUR,,0,0,0,34284.42,34284.42,34284.42,169709243.84999982,169709243.84999982,ACH,EUR
2025-02-27,Settlement from ClientLine,Processor Payout Batch,SET-20250225-ClientLine-Visa-CAD,,0,0,0,29982.33,29982.33,29982.33,169739226.17999983,169739226.17999983,ACH,CAD
2025-02-27,Settlement from ClientLine,Processor Payout Batch,SET-20250225-ClientLine-Visa-AUD,,0,0,0,28785.55,28785.55,28785.55,169768011.72999984,169768011.72999984,ACH,AUD
2025-02-27,Settlement from ClientLine,Processor Payout Batch,SET-20250225-ClientLine-Mastercard-USD,,0,0,0,174249.07,174249.07,174249.07,169942260.79999983,169942260.79999983,ACH,USD
2025-02-27,Settlement from ClientLine,Processor Payout Batch,SET-20250225-ClientLine-Mastercard-GBP,,0,0,0,26630.9,26630.9,26630.9,169968891.69999984,169968891.69999984,ACH,GBP
2025-02-27,Settlement from ClientLine,Processor Payout Batch,SET-20250225-ClientLine-Mastercard-EUR,,0,0,0,44535.55,44535.55,44535.55,170013427.24999985,170013427.24999985,ACH,EUR
2025-02-27,Settlement from ClientLine,Processor Payout Batch,SET-20250225-ClientLine-Mastercard-CAD,,0,0,0,22133.59,22133.59,22133.59,170035560.83999985,170035560.83999985,ACH,CAD
2025-02-27,Settlement from ClientLine,Processor Payout Batch,SET-20250225-ClientLine-Mastercard-AUD,,0,0,0,22141.2,22141.2,22141.2,170057702.03999984,170057702.03999984,ACH,AUD
2025-02-27,Settlement from Amex,Processor Payout Batch,SET-20250225-Amex-Amex-USD,,0,0,0,235013.68,235013.68,235013.68,170292715.71999985,170292715.71999985,ACH,USD
2025-02-27,Settlement from ClientLine,Processor Payout Batch,SET-20250225-ClientLine-Visa-USD,,0,0,0,189696.13,189696.13,189696.13,170482411.84999985,170482411.84999985,ACH,USD
2025-02-27,Settlement from Amex,Processor Payout Batch,SET-20250225-Amex-Amex-CAD,,0,0,0,26510.55,26510.55,26510.55,170508922.39999986,170508922.39999986,ACH,CAD
2025-02-27,Settlement from Amex,Processor Payout Batch,SET-20250223-Amex-Amex-AUD,,0,0,0,36032.09,36032.09,36032.09,170544954.48999986,170544954.48999986,ACH,AUD
2025-02-27,Settlement from PayPal,Processor Payout Batch,SET-20250223-PayPal-N/A-USD,,0,0,0,555447.41,555447.41,555447.41,171100401.89999986,171100401.89999986,ACH,USD
2025-02-27,Settlement from Amex,Processor Payout Batch,SET-20250223-Amex-Amex-CAD,,0,0,0,33183.1,33183.1,33183.1,171133584.99999985,171133584.99999985,ACH,CAD
2025-02-27,Settlement from Amex,Processor Payout Batch,SET-20250223-Amex-Amex-EUR,,0,0,0,59860.36,59860.36,59860.36,171193445.35999987,171193445.35999987,ACH,EUR
2025-02-27,Settlement from Amex,Processor Payout Batch,SET-20250223-Amex-Amex-GBP,,0,0,0,31944.19,31944.19,31944.19,171225389.54999986,171225389.54999986,ACH,GBP
2025-02-27,Settlement from Amex,Processor Payout Batch,SET-20250223-Amex-Amex-USD,,0,0,0,232447.15,232447.15,232447.15,171457836.69999987,171457836.69999987,ACH,USD
2025-02-27,Settlement from ClientLine,Processor Payout Batch,SET-20250223-ClientLine-Mastercard-AUD,,0,0,0,27547.12,27547.12,27547.12,171485383.81999987,171485383.81999987,ACH,AUD
2025-02-27,Settlement from ClientLine,Processor Payout Batch,SET-20250223-ClientLine-Mastercard-CAD,,0,0,0,30614.68,30614.68,30614.68,171515998.49999988,171515998.49999988,ACH,CAD
2025-02-27,Settlement from ClientLine,Processor Payout Batch,SET-20250223-ClientLine-Mastercard-GBP,,0,0,0,33629.78,33629.78,33629.78,171549628.27999988,171549628.27999988,ACH,GBP
2025-02-27,Settlement from ClientLine,Processor Payout Batch,SET-20250223-ClientLine-Mastercard-USD,,0,0,0,178556.96,178556.96,178556.96,171728185.2399999,171728185.2399999,ACH,USD
2025-02-27,Settlement from ClientLine,Processor Payout Batch,SET-20250223-ClientLine-Visa-AUD,,0,0,0,26014.09,26014.09,26014.09,171754199.3299999,171754199.3299999,ACH,AUD
2025-02-27,Settlement from ClientLine,Processor Payout Batch,SET-20250223-ClientLine-Visa-CAD,,0,0,0,15038.16,15038.16,15038.16,171769237.4899999,171769237.4899999,ACH,CAD
2025-02-27,Settlement from ClientLine,Processor Payout Batch,SET-20250223-ClientLine-Visa-EUR,,0,0,0,66241.15,66241.15,66241.15,171835478.6399999,171835478.6399999,ACH,EUR
2025-02-27,Settlement from ClientLine,Processor Payout Batch,SET-20250223-ClientLine-Mastercard-EUR,,0,0,0,54383.67,54383.67,54383.67,171889862.30999988,171889862.30999988,ACH,EUR
2025-02-27,Settlement from ClientLine,Processor Payout Batch,SET-20250223-ClientLine-Visa-USD,,0,0,0,199433.58,199433.58,199433.58,172089295.8899999,172089295.8899999,ACH,USD
2025-02-27,Settlement from GoCardless,Processor Payout Batch,SET-20250223-GoCardless-N/A-AUD,,0,0,0,66920.55,66920.55,66920.55,172156216.4399999,172156216.4399999,ACH,AUD
2025-02-27,Settlement from GoCardless,Processor Payout Batch,SET-20250223-GoCardless-N/A-CAD,,0,0,0,75849.06,75849.06,75849.06,172232065.4999999,172232065.4999999,ACH,CAD
2025-02-27,Settlement from GoCardless,Processor Payout Batch,SET-20250223-GoCardless-N/A-EUR,,0,0,0,120634.19,120634.19,120634.19,172352699.6899999,172352699.6899999,ACH,EUR
2025-02-27,Settlement from GoCardless,Processor Payout Batch,SET-20250223-GoCardless-N/A-GBP,,0,0,0,61290.96,61290.96,61290.96,172413990.64999992,172413990.64999992,ACH,GBP
2025-02-27,Settlement from GoCardless,Processor Payout Batch,SET-20250223-GoCardless-N/A-USD,,0,0,0,621588.7,621588.7,621588.7,173035579.3499999,173035579.3499999,ACH,USD
2025-02-27,Settlement from PayPal,Processor Payout Batch,SET-20250223-PayPal-N/A-AUD,,0,0,0,87440.35,87440.35,87440.35,173123019.6999999,173123019.6999999,ACH,AUD
2025-02-27,Settlement from PayPal,Processor Payout Batch,SET-20250223-PayPal-N/A-CAD,,0,0,0,46285.81,46285.81,46285.81,173169305.5099999,173169305.5099999,ACH,CAD
2025-02-27,Settlement from PayPal,Processor Payout Batch,SET-20250223-PayPal-N/A-EUR,,0,0,0,167954.39,167954.39,167954.39,173337259.8999999,173337259.8999999,ACH,EUR
2025-02-27,Settlement from PayPal,Processor Payout Batch,SET-20250223-PayPal-N/A-GBP,,0,0,0,108141.75,108141.75,108141.75,173445401.6499999,173445401.6499999,ACH,GBP
2025-02-27,Settlement from ClientLine,Processor Payout Batch,SET-20250223-ClientLine-Visa-GBP,,0,0,0,55868.36,55868.36,55868.36,173501270.0099999,173501270.0099999,ACH,GBP
2025-02-28,Settlement from GoCardless,Processor Payout Batch,SET-20250226-GoCardless-N/A-AUD,,0,0,0,98055.23,98055.23,98055.23,173599325.2399999,173599325.2399999,ACH,AUD
2025-02-28,Settlement from GoCardless,Processor Payout Batch,SET-20250226-GoCardless-N/A-CAD,,0,0,0,58502.92,58502.92,58502.92,173657828.15999988,173657828.15999988,ACH,CAD
2025-02-28,Settlement from GoCardless,Processor Payout Batch,SET-20250226-GoCardless-N/A-EUR,,0,0,0,162706.86,162706.86,162706.86,173820535.0199999,173820535.0199999,ACH,EUR
2025-02-28,Settlement from GoCardless,Processor Payout Batch,SET-20250226-GoCardless-N/A-GBP,,0,0,0,71179.41,71179.41,71179.41,173891714.4299999,173891714.4299999,ACH,GBP
2025-02-28,Settlement from GoCardless,Processor Payout Batch,SET-20250226-GoCardless-N/A-USD,,0,0,0,647293.44,647293.44,647293.44,174539007.8699999,174539007.8699999,ACH,USD
2025-02-28,Settlement from PayPal,Processor Payout Batch,SET-20250226-PayPal-N/A-USD,,0,0,0,657356.09,657356.09,657356.09,175196363.9599999,175196363.9599999,ACH,USD
2025-02-28,Settlement from PayPal,Processor Payout Batch,SET-20250226-PayPal-N/A-CAD,,0,0,0,54045.63,54045.63,54045.63,175250409.58999988,175250409.58999988,ACH,CAD
2025-02-28,Settlement from PayPal,Processor Payout Batch,SET-20250226-PayPal-N/A-EUR,,0,0,0,189163.98,189163.98,189163.98,175439573.56999987,175439573.56999987,ACH,EUR
2025-02-28,Settlement from PayPal,Processor Payout Batch,SET-20250226-PayPal-N/A-GBP,,0,0,0,95021.84,95021.84,95021.84,175534595.40999988,175534595.40999988,ACH,GBP
2025-02-28,Settlement from ClientLine,Processor Payout Batch,SET-20250226-ClientLine-Visa-USD,,0,0,0,171731.82,171731.82,171731.82,175706327.22999987,175706327.22999987,ACH,USD
2025-02-28,Settlement from PayPal,Processor Payout Batch,SET-20250226-PayPal-N/A-AUD,,0,0,0,91840.12,91840.12,91840.12,175798167.34999987,175798167.34999987,ACH,AUD
2025-02-28,Settlement from ClientLine,Processor Payout Batch,SET-20250226-ClientLine-Visa-GBP,,0,0,0,26060.66,26060.66,26060.66,175824228.00999987,175824228.00999987,ACH,GBP
2025-02-28,Settlement from ClientLine,Processor Payout Batch,SET-20250226-ClientLine-Visa-EUR,,0,0,0,46904.74,46904.74,46904.74,175871132.74999988,175871132.74999988,ACH,EUR
2025-02-28,Settlement from ClientLine,Processor Payout Batch,SET-20250226-ClientLine-Visa-CAD,,0,0,0,15586.62,15586.62,15586.62,175886719.3699999,175886719.3699999,ACH,CAD
2025-02-28,Settlement from Amex,Processor Payout Batch,SET-20250226-Amex-Amex-CAD,,0,0,0,23084.83,23084.83,23084.83,175909804.1999999,175909804.1999999,ACH,CAD
2025-02-28,Settlement from Amex,Processor Payout Batch,SET-20250226-Amex-Amex-EUR,,0,0,0,16775.06,16775.06,16775.06,175926579.2599999,175926579.2599999,ACH,EUR
2025-02-28,Settlement from Amex,Processor Payout Batch,SET-20250226-Amex-Amex-GBP,,0,0,0,36071.24,36071.24,36071.24,175962650.4999999,175962650.4999999,ACH,GBP
2025-02-28,Settlement from Amex,Processor Payout Batch,SET-20250226-Amex-Amex-USD,,0,0,0,217900.41,217900.41,217900.41,176180550.9099999,176180550.9099999,ACH,USD
2025-02-28,Settlement from ClientLine,Processor Payout Batch,SET-20250226-ClientLine-Mastercard-AUD,,0,0,0,22879.13,22879.13,22879.13,176203430.0399999,176203430.0399999,ACH,AUD
2025-02-28,Settlement from Amex,Processor Payout Batch,SET-20250226-Amex-Amex-AUD,,0,0,0,13202.94,13202.94,13202.94,176216632.9799999,176216632.9799999,ACH,AUD
2025-02-28,Settlement from ClientLine,Processor Payout Batch,SET-20250226-ClientLine-Mastercard-EUR,,0,0,0,50526.17,50526.17,50526.17,176267159.1499999,176267159.1499999,ACH,EUR
2025-02-28,Settlement from ClientLine,Processor Payout Batch,SET-20250226-ClientLine-Mastercard-GBP,,0,0,0,43001.7,43001.7,43001.7,176310160.84999987,176310160.84999987,ACH,GBP
2025-02-28,Settlement from ClientLine,Processor Payout Batch,SET-20250226-ClientLine-Mastercard-USD,,0,0,0,180602.26,180602.26,180602.26,176490763.10999987,176490763.10999987,ACH,USD
2025-02-28,Settlement from ClientLine,Processor Payout Batch,SET-20250226-ClientLine-Visa-AUD,,0,0,0,33540.83,33540.83,33540.83,176524303.93999988,176524303.93999988,ACH,AUD
2025-02-28,Settlement from ClientLine,Processor Payout Batch,SET-20250226-ClientLine-Mastercard-CAD,,0,0,0,40764.86,40764.86,40764.86,176565068.7999999,176565068.7999999,ACH,CAD
2025-03-03,Settlement from GoCardless,Processor Payout Batch,SET-20250227-GoCardless-N/A-AUD,,0,0,0,69173.11,69173.11,69173.11,176634241.9099999,176634241.9099999,ACH,AUD
2025-03-03,Settlement from GoCardless,Processor Payout Batch,SET-20250227-GoCardless-N/A-CAD,,0,0,0,93368.87,93368.87,93368.87,176727610.7799999,176727610.7799999,ACH,CAD
2025-03-03,Settlement from GoCardless,Processor Payout Batch,SET-20250227-GoCardless-N/A-EUR,,0,0,0,136570.04,136570.04,136570.04,176864180.8199999,176864180.8199999,ACH,EUR
2025-03-03,Settlement from GoCardless,Processor Payout Batch,SET-20250227-GoCardless-N/A-GBP,,0,0,0,114900.75,114900.75,114900.75,176979081.5699999,176979081.5699999,ACH,GBP
2025-03-03,Settlement from GoCardless,Processor Payout Batch,SET-20250227-GoCardless-N/A-USD,,0,0,0,646500.81,646500.81,646500.81,177625582.3799999,177625582.3799999,ACH,USD
2025-03-03,Settlement from PayPal,Processor Payout Batch,SET-20250227-PayPal-N/A-CAD,,0,0,0,89394.95,89394.95,89394.95,177714977.3299999,177714977.3299999,ACH,CAD
2025-03-03,Settlement from PayPal,Processor Payout Batch,SET-20250227-PayPal-N/A-EUR,,0,0,0,196522.89,196522.89,196522.89,177911500.21999988,177911500.21999988,ACH,EUR
2025-03-03,Settlement from PayPal,Processor Payout Batch,SET-20250227-PayPal-N/A-GBP,,0,0,0,94766.4,94766.4,94766.4,178006266.6199999,178006266.6199999,ACH,GBP
2025-03-03,Settlement from PayPal,Processor Payout Batch,SET-20250227-PayPal-N/A-USD,,0,0,0,558172.42,558172.42,558172.42,178564439.03999987,178564439.03999987,ACH,USD
2025-03-03,Settlement from ClientLine,Processor Payout Batch,SET-20250227-ClientLine-Visa-USD,,0,0,0,201184.65,201184.65,201184.65,178765623.68999988,178765623.68999988,ACH,USD
2025-03-03,Settlement from PayPal,Processor Payout Batch,SET-20250227-PayPal-N/A-AUD,,0,0,0,97906.88,97906.88,97906.88,178863530.56999987,178863530.56999987,ACH,AUD
2025-03-03,Settlement from ClientLine,Processor Payout Batch,SET-20250227-ClientLine-Visa-GBP,,0,0,0,25660.17,25660.17,25660.17,178889190.73999986,178889190.73999986,ACH,GBP
2025-03-03,Settlement from ClientLine,Processor Payout Batch,SET-20250227-ClientLine-Visa-EUR,,0,0,0,58715.46,58715.46,58715.46,178947906.19999987,178947906.19999987,ACH,EUR
2025-03-03,Settlement from ClientLine,Processor Payout Batch,SET-20250227-ClientLine-Visa-CAD,,0,0,0,11761.3,11761.3,11761.3,178959667.49999988,178959667.49999988,ACH,CAD
2025-03-03,Settlement from Amex,Processor Payout Batch,SET-20250227-Amex-Amex-CAD,,0,0,0,9249.42,9249.42,9249.42,178968916.91999987,178968916.91999987,ACH,CAD
2025-03-03,Settlement from Amex,Processor Payout Batch,SET-20250227-Amex-Amex-EUR,,0,0,0,23089.68,23089.68,23089.68,178992006.59999987,178992006.59999987,ACH,EUR
2025-03-03,Settlement from Amex,Processor Payout Batch,SET-20250227-Amex-Amex-GBP,,0,0,0,48970.08,48970.08,48970.08,179040976.6799999,179040976.6799999,ACH,GBP
2025-03-03,Settlement from Amex,Processor Payout Batch,SET-20250227-Amex-Amex-USD,,0,0,0,203916.51,203916.51,203916.51,179244893.18999988,179244893.18999988,ACH,USD
2025-03-03,Settlement from ClientLine,Processor Payout Batch,SET-20250227-ClientLine-Mastercard-AUD,,0,0,0,18637.11,18637.11,18637.11,179263530.2999999,179263530.2999999,ACH,AUD
2025-03-03,Settlement from Amex,Processor Payout Batch,SET-20250227-Amex-Amex-AUD,,0,0,0,32659.25,32659.25,32659.25,179296189.5499999,179296189.5499999,ACH,AUD
2025-03-03,Settlement from ClientLine,Processor Payout Batch,SET-20250227-ClientLine-Mastercard-EUR,,0,0,0,75141.75,75141.75,75141.75,179371331.2999999,179371331.2999999,ACH,EUR
2025-03-03,Settlement from ClientLine,Processor Payout Batch,SET-20250227-ClientLine-Mastercard-GBP,,0,0,0,24105.23,24105.23,24105.23,179395436.52999988,179395436.52999988,ACH,GBP
2025-03-03,Settlement from ClientLine,Processor Payout Batch,SET-20250227-ClientLine-Mastercard-USD,,0,0,0,235450.23,235450.23,235450.23,179630886.75999987,179630886.75999987,ACH,USD
2025-03-03,Settlement from ClientLine,Processor Payout Batch,SET-20250227-ClientLine-Visa-AUD,,0,0,0,25617.26,25617.26,25617.26,179656504.01999986,179656504.01999986,ACH,AUD
2025-03-03,Settlement from ClientLine,Processor Payout Batch,SET-20250227-ClientLine-Mastercard-CAD,,0,0,0,20491.9,20491.9,20491.9,179676995.91999987,179676995.91999987,ACH,CAD
2025-03-04,Settlement from GoCardless,Processor Payout Batch,SET-20250228-GoCardless-N/A-AUD,,0,0,0,67440.0,67440.0,67440.0,179744435.91999987,179744435.91999987,ACH,AUD
2025-03-04,Settlement from GoCardless,Processor Payout Batch,SET-20250228-GoCardless-N/A-CAD,,0,0,0,85849.88,85849.88,85849.88,179830285.79999986,179830285.79999986,ACH,CAD
2025-03-04,Settlement from GoCardless,Processor Payout Batch,SET-20250228-GoCardless-N/A-EUR,,0,0,0,136484.09,136484.09,136484.09,179966769.88999987,179966769.88999987,ACH,EUR
2025-03-04,Settlement from GoCardless,Processor Payout Batch,SET-20250228-GoCardless-N/A-GBP,,0,0,0,73517.23,73517.23,73517.23,180040287.11999986,180040287.11999986,ACH,GBP
2025-03-04,Settlement from GoCardless,Processor Payout Batch,SET-20250228-GoCardless-N/A-USD,,0,0,0,670355.99,670355.99,670355.99,180710643.10999987,180710643.10999987,ACH,USD
2025-03-04,Settlement from PayPal,Processor Payout Batch,SET-20250228-PayPal-N/A-CAD,,0,0,0,98282.9,98282.9,98282.9,180808926.00999987,180808926.00999987,ACH,CAD
2025-03-04,Settlement from PayPal,Processor Payout Batch,SET-20250228-PayPal-N/A-EUR,,0,0,0,146244.31,146244.31,146244.31,180955170.31999987,180955170.31999987,ACH,EUR
2025-03-04,Settlement from PayPal,Processor Payout Batch,SET-20250228-PayPal-N/A-GBP,,0,0,0,130557.58,130557.58,130557.58,181085727.8999999,181085727.8999999,ACH,GBP
2025-03-04,Settlement from PayPal,Processor Payout Batch,SET-20250228-PayPal-N/A-USD,,0,0,0,561902.82,561902.82,561902.82,181647630.71999988,181647630.71999988,ACH,USD
2025-03-04,Settlement from ClientLine,Processor Payout Batch,SET-20250228-ClientLine-Visa-USD,,0,0,0,170671.73,170671.73,170671.73,181818302.44999987,181818302.44999987,ACH,USD
2025-03-04,Settlement from PayPal,Processor Payout Batch,SET-20250228-PayPal-N/A-AUD,,0,0,0,144310.17,144310.17,144310.17,181962612.61999986,181962612.61999986,ACH,AUD
2025-03-04,Settlement from ClientLine,Processor Payout Batch,SET-20250228-ClientLine-Visa-GBP,,0,0,0,32082.92,32082.92,32082.92,181994695.53999984,181994695.53999984,ACH,GBP
2025-03-04,Settlement from ClientLine,Processor Payout Batch,SET-20250228-ClientLine-Mastercard-CAD,,0,0,0,38752.39,38752.39,38752.39,182033447.92999983,182033447.92999983,ACH,CAD
2025-03-04,Settlement from ClientLine,Processor Payout Batch,SET-20250228-ClientLine-Visa-CAD,,0,0,0,25850.55,25850.55,25850.55,182059298.47999984,182059298.47999984,ACH,CAD
2025-03-04,Settlement from ClientLine,Processor Payout Batch,SET-20250228-ClientLine-Visa-EUR,,0,0,0,40813.71,40813.71,40813.71,182100112.18999985,182100112.18999985,ACH,EUR
2025-03-04,Settlement from Amex,Processor Payout Batch,SET-20250228-Amex-Amex-CAD,,0,0,0,33140.0,33140.0,33140.0,182133252.18999985,182133252.18999985,ACH,CAD
2025-03-04,Settlement from Amex,Processor Payout Batch,SET-20250228-Amex-Amex-EUR,,0,0,0,41129.43,41129.43,41129.43,182174381.61999986,182174381.61999986,ACH,EUR
2025-03-04,Settlement from Amex,Processor Payout Batch,SET-20250228-Amex-Amex-GBP,,0,0,0,31838.92,31838.92,31838.92,182206220.53999984,182206220.53999984,ACH,GBP
2025-03-04,Settlement from Amex,Processor Payout Batch,SET-20250228-Amex-Amex-USD,,0,0,0,206641.73,206641.73,206641.73,182412862.26999983,182412862.26999983,ACH,USD
2025-03-04,Settlement from Amex,Processor Payout Batch,SET-20250228-Amex-Amex-AUD,,0,0,0,26698.71,26698.71,26698.71,182439560.97999984,182439560.97999984,ACH,AUD
2025-03-04,Settlement from ClientLine,Processor Payout Batch,SET-20250228-ClientLine-Mastercard-EUR,,0,0,0,56721.96,56721.96,56721.96,182496282.93999985,182496282.93999985,ACH,EUR
2025-03-04,Settlement from ClientLine,Processor Payout Batch,SET-20250228-ClientLine-Mastercard-GBP,,0,0,0,41126.9,41126.9,41126.9,182537409.83999985,182537409.83999985,ACH,GBP
2025-03-04,Settlement from ClientLine,Processor Payout Batch,SET-20250228-ClientLine-Mastercard-USD,,0,0,0,183435.78,183435.78,183435.78,182720845.61999986,182720845.61999986,ACH,USD
2025-03-04,Settlement from ClientLine,Processor Payout Batch,SET-20250228-ClientLine-Visa-AUD,,0,0,0,18287.92,18287.92,18287.92,182739133.53999984,182739133.53999984,ACH,AUD
2025-03-04,Settlement from ClientLine,Processor Payout Batch,SET-20250228-ClientLine-Mastercard-AUD,,0,0,0,20562.16,20562.16,20562.16,182759695.69999984,182759695.69999984,ACH,AUD
2025-03-05,Settlement from Amex,Processor Payout Batch,SET-20250303-Amex-Amex-EUR,,0,0,0,49555.52,49555.52,49555.52,182809251.21999985,182809251.21999985,ACH,EUR
2025-03-05,Settlement from ClientLine,Processor Payout Batch,SET-20250303-ClientLine-Visa-CAD,,0,0,0,26481.05,26481.05,26481.05,182835732.26999986,182835732.26999986,ACH,CAD
2025-03-05,Settlement from Amex,Processor Payout Batch,SET-20250303-Amex-Amex-GBP,,0,0,0,17714.55,17714.55,17714.55,182853446.81999987,182853446.81999987,ACH,GBP
2025-03-05,Settlement from Amex,Processor Payout Batch,SET-20250303-Amex-Amex-USD,,0,0,0,153527.9,153527.9,153527.9,183006974.71999988,183006974.71999988,ACH,USD
2025-03-05,Settlement from ClientLine,Processor Payout Batch,SET-20250303-ClientLine-Mastercard-AUD,,0,0,0,47651.1,47651.1,47651.1,183054625.81999987,183054625.81999987,ACH,AUD
2025-03-05,Settlement from ClientLine,Processor Payout Batch,SET-20250303-ClientLine-Mastercard-CAD,,0,0,0,16438.57,16438.57,16438.57,183071064.38999987,183071064.38999987,ACH,CAD
2025-03-05,Settlement from ClientLine,Processor Payout Batch,SET-20250303-ClientLine-Mastercard-EUR,,0,0,0,64527.99,64527.99,64527.99,183135592.37999988,183135592.37999988,ACH,EUR
2025-03-05,Settlement from ClientLine,Processor Payout Batch,SET-20250303-ClientLine-Mastercard-GBP,,0,0,0,17870.55,17870.55,17870.55,183153462.9299999,183153462.9299999,ACH,GBP
2025-03-05,Settlement from ClientLine,Processor Payout Batch,SET-20250303-ClientLine-Mastercard-USD,,0,0,0,237708.52,237708.52,237708.52,183391171.4499999,183391171.4499999,ACH,USD
2025-03-05,Settlement from ClientLine,Processor Payout Batch,SET-20250303-ClientLine-Visa-AUD,,0,0,0,18189.39,18189.39,18189.39,183409360.83999988,183409360.83999988,ACH,AUD
2025-03-05,Settlement from ClientLine,Processor Payout Batch,SET-20250303-ClientLine-Visa-EUR,,0,0,0,31979.6,31979.6,31979.6,183441340.43999988,183441340.43999988,ACH,EUR
2025-03-05,Settlement from GoCardless,Processor Payout Batch,SET-20250303-GoCardless-N/A-GBP,,0,0,0,128591.73,128591.73,128591.73,183569932.16999987,183569932.16999987,ACH,GBP
2025-03-05,Settlement from ClientLine,Processor Payout Batch,SET-20250303-ClientLine-Visa-USD,,0,0,0,200550.59,200550.59,200550.59,183770482.75999987,183770482.75999987,ACH,USD
2025-03-05,Settlement from GoCardless,Processor Payout Batch,SET-20250303-GoCardless-N/A-AUD,,0,0,0,71240.72,71240.72,71240.72,183841723.47999987,183841723.47999987,ACH,AUD
2025-03-05,Settlement from GoCardless,Processor Payout Batch,SET-20250303-GoCardless-N/A-CAD,,0,0,0,67376.32,67376.32,67376.32,183909099.79999986,183909099.79999986,ACH,CAD
2025-03-05,Settlement from GoCardless,Processor Payout Batch,SET-20250303-GoCardless-N/A-EUR,,0,0,0,168815.1,168815.1,168815.1,184077914.89999986,184077914.89999986,ACH,EUR
2025-03-05,Settlement from PayPal,Processor Payout Batch,SET-20250303-PayPal-N/A-USD,,0,0,0,625479.7,625479.7,625479.7,184703394.59999985,184703394.59999985,ACH,USD
2025-03-05,Settlement from GoCardless,Processor Payout Batch,SET-20250303-GoCardless-N/A-USD,,0,0,0,568558.72,568558.72,568558.72,185271953.31999984,185271953.31999984,ACH,USD
2025-03-05,Settlement from PayPal,Processor Payout Batch,SET-20250303-PayPal-N/A-AUD,,0,0,0,88799.96,88799.96,88799.96,185360753.27999985,185360753.27999985,ACH,AUD
2025-03-05,Settlement from PayPal,Processor Payout Batch,SET-20250303-PayPal-N/A-CAD,,0,0,0,61343.76,61343.76,61343.76,185422097.03999984,185422097.03999984,ACH,CAD
2025-03-05,Settlement from PayPal,Processor Payout Batch,SET-20250303-PayPal-N/A-EUR,,0,0,0,142246.59,142246.59,142246.59,185564343.62999985,185564343.62999985,ACH,EUR
2025-03-05,Settlement from PayPal,Processor Payout Batch,SET-20250303-PayPal-N/A-GBP,,0,0,0,96120.35,96120.35,96120.35,185660463.97999984,185660463.97999984,ACH,GBP
2025-03-05,Settlement from Amex,Processor Payout Batch,SET-20250303-Amex-Amex-CAD,,0,0,0,20543.41,20543.41,20543.41,185681007.38999984,185681007.38999984,ACH,CAD
2025-03-05,Settlement from ClientLine,Processor Payout Batch,SET-20250303-ClientLine-Visa-GBP,,0,0,0,44445.11,44445.11,44445.11,185725452.49999985,185725452.49999985,ACH,GBP
2025-03-05,Settlement from Amex,Processor Payout Batch,SET-20250303-Amex-Amex-AUD,,0,0,0,26603.16,26603.16,26603.16,185752055.65999985,185752055.65999985,ACH,AUD
2025-03-05,Settlement from ClientLine,Processor Payout Batch,SET-20250301-ClientLine-Mastercard-AUD,,0,0,0,19527.46,19527.46,19527.46,185771583.11999986,185771583.11999986,ACH,AUD
2025-03-05,Settlement from PayPal,Processor Payout Batch,SET-20250301-PayPal-N/A-USD,,0,0,0,549995.14,549995.14,549995.14,186321578.25999984,186321578.25999984,ACH,USD
2025-03-05,Settlement from PayPal,Processor Payout Batch,SET-20250301-PayPal-N/A-EUR,,0,0,0,138558.51,138558.51,138558.51,186460136.76999983,186460136.76999983,ACH,EUR
2025-03-05,Settlement from PayPal,Processor Payout Batch,SET-20250301-PayPal-N/A-CAD,,0,0,0,34465.5,34465.5,34465.5,186494602.26999983,186494602.26999983,ACH,CAD
2025-03-05,Settlement from PayPal,Processor Payout Batch,SET-20250301-PayPal-N/A-AUD,,0,0,0,86845.81,86845.81,86845.81,186581448.07999983,186581448.07999983,ACH,AUD
2025-03-05,Settlement from GoCardless,Processor Payout Batch,SET-20250301-GoCardless-N/A-USD,,0,0,0,545609.8,545609.8,545609.8,187127057.87999985,187127057.87999985,ACH,USD
2025-03-05,Settlement from GoCardless,Processor Payout Batch,SET-20250301-GoCardless-N/A-GBP,,0,0,0,89676.04,89676.04,89676.04,187216733.91999984,187216733.91999984,ACH,GBP
2025-03-05,Settlement from GoCardless,Processor Payout Batch,SET-20250301-GoCardless-N/A-EUR,,0,0,0,146860.93,146860.93,146860.93,187363594.84999985,187363594.84999985,ACH,EUR
2025-03-05,Settlement from GoCardless,Processor Payout Batch,SET-20250301-GoCardless-N/A-CAD,,0,0,0,77519.82,77519.82,77519.82,187441114.66999984,187441114.66999984,ACH,CAD
2025-03-05,Settlement from GoCardless,Processor Payout Batch,SET-20250301-GoCardless-N/A-AUD,,0,0,0,92551.89,92551.89,92551.89,187533666.55999982,187533666.55999982,ACH,AUD
2025-03-05,Settlement from ClientLine,Processor Payout Batch,SET-20250301-ClientLine-Visa-USD,,0,0,0,221239.01,221239.01,221239.01,187754905.5699998,187754905.5699998,ACH,USD
2025-03-05,Settlement from ClientLine,Processor Payout Batch,SET-20250301-ClientLine-Visa-GBP,,0,0,0,25598.96,25598.96,25598.96,187780504.52999982,187780504.52999982,ACH,GBP
2025-03-05,Settlement from ClientLine,Processor Payout Batch,SET-20250301-ClientLine-Visa-EUR,,0,0,0,50388.34,50388.34,50388.34,187830892.86999983,187830892.86999983,ACH,EUR
2025-03-05,Settlement from ClientLine,Processor Payout Batch,SET-20250301-ClientLine-Visa-CAD,,0,0,0,17187.63,17187.63,17187.63,187848080.49999982,187848080.49999982,ACH,CAD
2025-03-05,Settlement from ClientLine,Processor Payout Batch,SET-20250301-ClientLine-Visa-AUD,,0,0,0,19420.91,19420.91,19420.91,187867501.40999982,187867501.40999982,ACH,AUD
2025-03-05,Settlement from ClientLine,Processor Payout Batch,SET-20250301-ClientLine-Mastercard-USD,,0,0,0,176425.68,176425.68,176425.68,188043927.08999982,188043927.08999982,ACH,USD
2025-03-05,Settlement from ClientLine,Processor Payout Batch,SET-20250301-ClientLine-Mastercard-GBP,,0,0,0,42385.93,42385.93,42385.93,188086313.01999983,188086313.01999983,ACH,GBP
2025-03-05,Settlement from ClientLine,Processor Payout Batch,SET-20250301-ClientLine-Mastercard-EUR,,0,0,0,51315.23,51315.23,51315.23,188137628.24999982,188137628.24999982,ACH,EUR
2025-03-05,Settlement from ClientLine,Processor Payout Batch,SET-20250301-ClientLine-Mastercard-CAD,,0,0,0,38261.15,38261.15,38261.15,188175889.39999983,188175889.39999983,ACH,CAD
2025-03-05,Settlement from Amex,Processor Payout Batch,SET-20250301-Amex-Amex-USD,,0,0,0,210306.85,210306.85,210306.85,188386196.24999982,188386196.24999982,ACH,USD
2025-03-05,Settlement from Amex,Processor Payout Batch,SET-20250301-Amex-Amex-GBP,,0,0,0,42606.93,42606.93,42606.93,188428803.17999983,188428803.17999983,ACH,GBP
2025-03-05,Settlement from Amex,Processor Payout Batch,SET-20250301-Amex-Amex-EUR,,0,0,0,75159.78,75159.78,75159.78,188503962.95999983,188503962.95999983,ACH,EUR
2025-03-05,Settlement from Amex,Processor Payout Batch,SET-20250301-Amex-Amex-CAD,,0,0,0,14061.98,14061.98,14061.98,188518024.93999982,188518024.93999982,ACH,CAD
2025-03-05,Settlement from PayPal,Processor Payout Batch,SET-20250301-PayPal-N/A-GBP,,0,0,0,85980.03,85980.03,85980.03,188604004.96999982,188604004.96999982,ACH,GBP
2025-03-05,Settlement from Amex,Processor Payout Batch,SET-20250301-Amex-Amex-AUD,,0,0,0,48946.38,48946.38,48946.38,188652951.34999982,188652951.34999982,ACH,AUD
2025-03-06,Settlement from Amex,Processor Payout Batch,SET-20250302-Amex-Amex-CAD,,0,0,0,13188.81,13188.81,13188.81,188666140.15999982,188666140.15999982,ACH,CAD
2025-03-06,Settlement from Amex,Processor Payout Batch,SET-20250304-Amex-Amex-GBP,,0,0,0,39739.22,39739.22,39739.22,188705879.37999982,188705879.37999982,ACH,GBP
2025-03-06,Settlement from PayPal,Processor Payout Batch,SET-20250304-PayPal-N/A-USD,,0,0,0,649612.76,649612.76,649612.76,189355492.1399998,189355492.1399998,ACH,USD
2025-03-06,Settlement from PayPal,Processor Payout Batch,SET-20250304-PayPal-N/A-GBP,,0,0,0,97136.05,97136.05,97136.05,189452628.18999982,189452628.18999982,ACH,GBP
2025-03-06,Settlement from PayPal,Processor Payout Batch,SET-20250304-PayPal-N/A-EUR,,0,0,0,131957.47,131957.47,131957.47,189584585.65999982,189584585.65999982,ACH,EUR
2025-03-06,Settlement from PayPal,Processor Payout Batch,SET-20250304-PayPal-N/A-CAD,,0,0,0,58579.38,58579.38,58579.38,189643165.0399998,189643165.0399998,ACH,CAD
2025-03-06,Settlement from PayPal,Processor Payout Batch,SET-20250304-PayPal-N/A-AUD,,0,0,0,84507.7,84507.7,84507.7,189727672.7399998,189727672.7399998,ACH,AUD
2025-03-06,Settlement from GoCardless,Processor Payout Batch,SET-20250304-GoCardless-N/A-USD,,0,0,0,544462.48,544462.48,544462.48,190272135.2199998,190272135.2199998,ACH,USD
2025-03-06,Settlement from Amex,Processor Payout Batch,SET-20250302-Amex-Amex-AUD,,0,0,0,25461.37,25461.37,25461.37,190297596.5899998,190297596.5899998,ACH,AUD
2025-03-06,Settlement from GoCardless,Processor Payout Batch,SET-20250304-GoCardless-N/A-EUR,,0,0,0,119621.14,119621.14,119621.14,190417217.72999978,190417217.72999978,ACH,EUR
2025-03-06,Settlement from GoCardless,Processor Payout Batch,SET-20250304-GoCardless-N/A-CAD,,0,0,0,83520.22,83520.22,83520.22,190500737.94999978,190500737.94999978,ACH,CAD
2025-03-06,Settlement from GoCardless,Processor Payout Batch,SET-20250304-GoCardless-N/A-AUD,,0,0,0,67213.49,67213.49,67213.49,190567951.4399998,190567951.4399998,ACH,AUD
2025-03-06,Settlement from ClientLine,Processor Payout Batch,SET-20250304-ClientLine-Visa-USD,,0,0,0,211591.17,211591.17,211591.17,190779542.60999978,190779542.60999978,ACH,USD
2025-03-06,Settlement from ClientLine,Processor Payout Batch,SET-20250304-ClientLine-Visa-GBP,,0,0,0,39033.39,39033.39,39033.39,190818575.99999976,190818575.99999976,ACH,GBP
2025-03-06,Settlement from ClientLine,Processor Payout Batch,SET-20250304-ClientLine-Visa-EUR,,0,0,0,46437.6,46437.6,46437.6,190865013.59999976,190865013.59999976,ACH,EUR
2025-03-06,Settlement from ClientLine,Processor Payout Batch,SET-20250304-ClientLine-Visa-CAD,,0,0,0,10672.19,10672.19,10672.19,190875685.78999975,190875685.78999975,ACH,CAD
2025-03-06,Settlement from ClientLine,Processor Payout Batch,SET-20250304-ClientLine-Visa-AUD,,0,0,0,30363.46,30363.46,30363.46,190906049.24999976,190906049.24999976,ACH,AUD
2025-03-06,Settlement from ClientLine,Processor Payout Batch,SET-20250304-ClientLine-Mastercard-USD,,0,0,0,256643.21,256643.21,256643.21,191162692.45999977,191162692.45999977,ACH,USD
2025-03-06,Settlement from ClientLine,Processor Payout Batch,SET-20250304-ClientLine-Mastercard-GBP,,0,0,0,34032.34,34032.34,34032.34,191196724.79999977,191196724.79999977,ACH,GBP
2025-03-06,Settlement from ClientLine,Processor Payout Batch,SET-20250304-ClientLine-Mastercard-EUR,,0,0,0,67505.24,67505.24,67505.24,191264230.03999978,191264230.03999978,ACH,EUR
2025-03-06,Settlement from ClientLine,Processor Payout Batch,SET-20250304-ClientLine-Mastercard-CAD,,0,0,0,27680.95,27680.95,27680.95,191291910.98999977,191291910.98999977,ACH,CAD
2025-03-06,Settlement from ClientLine,Processor Payout Batch,SET-20250304-ClientLine-Mastercard-AUD,,0,0,0,35432.4,35432.4,35432.4,191327343.38999978,191327343.38999978,ACH,AUD
2025-03-06,Settlement from Amex,Processor Payout Batch,SET-20250304-Amex-Amex-USD,,0,0,0,184060.46,184060.46,184060.46,191511403.8499998,191511403.8499998,ACH,USD
2025-03-06,Settlement from Amex,Processor Payout Batch,SET-20250304-Amex-Amex-EUR,,0,0,0,50471.17,50471.17,50471.17,191561875.01999977,191561875.01999977,ACH,EUR
2025-03-06,Settlement from Amex,Processor Payout Batch,SET-20250304-Amex-Amex-CAD,,0,0,0,25002.98,25002.98,25002.98,191586877.99999976,191586877.99999976,ACH,CAD
2025-03-06,Settlement from GoCardless,Processor Payout Batch,SET-20250304-GoCardless-N/A-GBP,,0,0,0,116347.0,116347.0,116347.0,191703224.99999976,191703224.99999976,ACH,GBP
2025-03-06,Settlement from ClientLine,Processor Payout Batch,SET-20250302-ClientLine-Mastercard-GBP,,0,0,0,33203.21,33203.21,33203.21,191736428.20999977,191736428.20999977,ACH,GBP
2025-03-06,Settlement from Amex,Processor Payout Batch,SET-20250302-Amex-Amex-EUR,,0,0,0,52457.6,52457.6,52457.6,191788885.80999976,191788885.80999976,ACH,EUR
2025-03-06,Settlement from Amex,Processor Payout Batch,SET-20250302-Amex-Amex-GBP,,0,0,0,39809.12,39809.12,39809.12,191828694.92999977,191828694.92999977,ACH,GBP
2025-03-06,Settlement from Amex,Processor Payout Batch,SET-20250302-Amex-Amex-USD,,0,0,0,199315.18,199315.18,199315.18,192028010.10999978,192028010.10999978,ACH,USD
2025-03-06,Settlement from ClientLine,Processor Payout Batch,SET-20250302-ClientLine-Mastercard-AUD,,0,0,0,15071.93,15071.93,15071.93,192043082.03999978,192043082.03999978,ACH,AUD
2025-03-06,Settlement from ClientLine,Processor Payout Batch,SET-20250302-ClientLine-Mastercard-CAD,,0,0,0,12342.42,12342.42,12342.42,192055424.45999977,192055424.45999977,ACH,CAD
2025-03-06,Settlement from ClientLine,Processor Payout Batch,SET-20250302-ClientLine-Mastercard-EUR,,0,0,0,62015.48,62015.48,62015.48,192117439.93999976,192117439.93999976,ACH,EUR
2025-03-06,Settlement from ClientLine,Processor Payout Batch,SET-20250302-ClientLine-Mastercard-USD,,0,0,0,239639.37,239639.37,239639.37,192357079.30999976,192357079.30999976,ACH,USD
2025-03-06,Settlement from ClientLine,Processor Payout Batch,SET-20250302-ClientLine-Visa-AUD,,0,0,0,21547.18,21547.18,21547.18,192378626.48999977,192378626.48999977,ACH,AUD
2025-03-06,Settlement from ClientLine,Processor Payout Batch,SET-20250302-ClientLine-Visa-CAD,,0,0,0,25945.42,25945.42,25945.42,192404571.90999976,192404571.90999976,ACH,CAD
2025-03-06,Settlement from Amex,Processor Payout Batch,SET-20250304-Amex-Amex-AUD,,0,0,0,14862.5,14862.5,14862.5,192419434.40999976,192419434.40999976,ACH,AUD
2025-03-06,Settlement from ClientLine,Processor Payout Batch,SET-20250302-ClientLine-Visa-GBP,,0,0,0,21324.78,21324.78,21324.78,192440759.18999976,192440759.18999976,ACH,GBP
2025-03-06,Settlement from ClientLine,Processor Payout Batch,SET-20250302-ClientLine-Visa-EUR,,0,0,0,43843.95,43843.95,43843.95,192484603.13999975,192484603.13999975,ACH,EUR
2025-03-06,Settlement from GoCardless,Processor Payout Batch,SET-20250302-GoCardless-N/A-AUD,,0,0,0,90525.57,90525.57,90525.57,192575128.70999974,192575128.70999974,ACH,AUD
2025-03-06,Settlement from GoCardless,Processor Payout Batch,SET-20250302-GoCardless-N/A-CAD,,0,0,0,85963.2,85963.2,85963.2,192661091.90999973,192661091.90999973,ACH,CAD
2025-03-06,Settlement from GoCardless,Processor Payout Batch,SET-20250302-GoCardless-N/A-EUR,,0,0,0,179219.56,179219.56,179219.56,192840311.46999973,192840311.46999973,ACH,EUR
2025-03-06,Settlement from GoCardless,Processor Payout Batch,SET-20250302-GoCardless-N/A-GBP,,0,0,0,94938.19,94938.19,94938.19,192935249.65999973,192935249.65999973,ACH,GBP
2025-03-06,Settlement from GoCardless,Processor Payout Batch,SET-20250302-GoCardless-N/A-USD,,0,0,0,592285.37,592285.37,592285.37,193527535.02999973,193527535.02999973,ACH,USD
2025-03-06,Settlement from PayPal,Processor Payout Batch,SET-20250302-PayPal-N/A-AUD,,0,0,0,61855.41,61855.41,61855.41,193589390.43999973,193589390.43999973,ACH,AUD
2025-03-06,Settlement from PayPal,Processor Payout Batch,SET-20250302-PayPal-N/A-CAD,,0,0,0,76824.68,76824.68,76824.68,193666215.11999974,193666215.11999974,ACH,CAD
2025-03-06,Settlement from PayPal,Processor Payout Batch,SET-20250302-PayPal-N/A-EUR,,0,0,0,142103.13,142103.13,142103.13,193808318.24999973,193808318.24999973,ACH,EUR
2025-03-06,Settlement from PayPal,Processor Payout Batch,SET-20250302-PayPal-N/A-GBP,,0,0,0,119150.33,119150.33,119150.33,193927468.57999974,193927468.57999974,ACH,GBP
2025-03-06,Settlement from PayPal,Processor Payout Batch,SET-20250302-PayPal-N/A-USD,,0,0,0,600286.13,600286.13,600286.13,194527754.70999974,194527754.70999974,ACH,USD
2025-03-06,Settlement from ClientLine,Processor Payout Batch,SET-20250302-ClientLine-Visa-USD,,0,0,0,190933.78,190933.78,190933.78,194718688.48999974,194718688.48999974,ACH,USD
2025-03-07,Settlement from ClientLine,Processor Payout Batch,SET-20250305-ClientLine-Visa-USD,,0,0,0,202714.34,202714.34,202714.34,194921402.82999974,194921402.82999974,ACH,USD
2025-03-07,Settlement from GoCardless,Processor Payout Batch,SET-20250305-GoCardless-N/A-CAD,,0,0,0,79769.34,79769.34,79769.34,195001172.16999975,195001172.16999975,ACH,CAD
2025-03-07,Settlement from GoCardless,Processor Payout Batch,SET-20250305-GoCardless-N/A-EUR,,0,0,0,150872.98,150872.98,150872.98,195152045.14999974,195152045.14999974,ACH,EUR
2025-03-07,Settlement from GoCardless,Processor Payout Batch,SET-20250305-GoCardless-N/A-USD,,0,0,0,628059.73,628059.73,628059.73,195780104.87999973,195780104.87999973,ACH,USD
2025-03-07,Settlement from GoCardless,Processor Payout Batch,SET-20250305-GoCardless-N/A-GBP,,0,0,0,101103.98,101103.98,101103.98,195881208.85999972,195881208.85999972,ACH,GBP
2025-03-07,Settlement from PayPal,Processor Payout Batch,SET-20250305-PayPal-N/A-CAD,,0,0,0,39231.57,39231.57,39231.57,195920440.4299997,195920440.4299997,ACH,CAD
2025-03-07,Settlement from PayPal,Processor Payout Batch,SET-20250305-PayPal-N/A-EUR,,0,0,0,167415.54,167415.54,167415.54,196087855.9699997,196087855.9699997,ACH,EUR
2025-03-07,Settlement from PayPal,Processor Payout Batch,SET-20250305-PayPal-N/A-GBP,,0,0,0,100916.92,100916.92,100916.92,196188772.8899997,196188772.8899997,ACH,GBP
2025-03-07,Settlement from PayPal,Processor Payout Batch,SET-20250305-PayPal-N/A-USD,,0,0,0,660111.24,660111.24,660111.24,196848884.1299997,196848884.1299997,ACH,USD
2025-03-07,Settlement from ClientLine,Processor Payout Batch,SET-20250305-ClientLine-Visa-GBP,,0,0,0,40041.26,40041.26,40041.26,196888925.3899997,196888925.3899997,ACH,GBP
2025-03-07,Settlement from PayPal,Processor Payout Batch,SET-20250305-PayPal-N/A-AUD,,0,0,0,57656.47,57656.47,57656.47,196946581.8599997,196946581.8599997,ACH,AUD
2025-03-07,Settlement from ClientLine,Processor Payout Batch,SET-20250305-ClientLine-Visa-EUR,,0,0,0,32926.54,32926.54,32926.54,196979508.39999968,196979508.39999968,ACH,EUR
2025-03-07,Settlement from GoCardless,Processor Payout Batch,SET-20250305-GoCardless-N/A-AUD,,0,0,0,86647.5,86647.5,86647.5,197066155.89999968,197066155.89999968,ACH,AUD
2025-03-07,Settlement from ClientLine,Processor Payout Batch,SET-20250305-ClientLine-Visa-AUD,,0,0,0,26424.64,26424.64,26424.64,197092580.53999966,197092580.53999966,ACH,AUD
2025-03-07,Settlement from ClientLine,Processor Payout Batch,SET-20250305-ClientLine-Visa-CAD,,0,0,0,23083.26,23083.26,23083.26,197115663.79999965,197115663.79999965,ACH,CAD
2025-03-07,Settlement from Amex,Processor Payout Batch,SET-20250305-Amex-Amex-CAD,,0,0,0,19508.01,19508.01,19508.01,197135171.80999964,197135171.80999964,ACH,CAD
2025-03-07,Settlement from Amex,Processor Payout Batch,SET-20250305-Amex-Amex-EUR,,0,0,0,51709.1,51709.1,51709.1,197186880.90999964,197186880.90999964,ACH,EUR
2025-03-07,Settlement from Amex,Processor Payout Batch,SET-20250305-Amex-Amex-GBP,,0,0,0,17743.37,17743.37,17743.37,197204624.27999964,197204624.27999964,ACH,GBP
2025-03-07,Settlement from Amex,Processor Payout Batch,SET-20250305-Amex-Amex-USD,,0,0,0,166988.65,166988.65,166988.65,197371612.92999965,197371612.92999965,ACH,USD
2025-03-07,Settlement from Amex,Processor Payout Batch,SET-20250305-Amex-Amex-AUD,,0,0,0,15590.48,15590.48,15590.48,197387203.40999964,197387203.40999964,ACH,AUD
2025-03-07,Settlement from ClientLine,Processor Payout Batch,SET-20250305-ClientLine-Mastercard-CAD,,0,0,0,22751.77,22751.77,22751.77,197409955.17999965,197409955.17999965,ACH,CAD
2025-03-07,Settlement from ClientLine,Processor Payout Batch,SET-20250305-ClientLine-Mastercard-EUR,,0,0,0,53322.6,53322.6,53322.6,197463277.77999964,197463277.77999964,ACH,EUR
2025-03-07,Settlement from ClientLine,Processor Payout Batch,SET-20250305-ClientLine-Mastercard-GBP,,0,0,0,40213.97,40213.97,40213.97,197503491.74999964,197503491.74999964,ACH,GBP
2025-03-07,Settlement from ClientLine,Processor Payout Batch,SET-20250305-ClientLine-Mastercard-USD,,0,0,0,218642.03,218642.03,218642.03,197722133.77999964,197722133.77999964,ACH,USD
2025-03-07,Settlement from ClientLine,Processor Payout Batch,SET-20250305-ClientLine-Mastercard-AUD,,0,0,0,29048.36,29048.36,29048.36,197751182.13999966,197751182.13999966,ACH,AUD
2025-03-10,Settlement from GoCardless,Processor Payout Batch,SET-20250306-GoCardless-N/A-AUD,,0,0,0,89488.29,89488.29,89488.29,197840670.42999965,197840670.42999965,ACH,AUD
2025-03-10,Settlement from GoCardless,Processor Payout Batch,SET-20250306-GoCardless-N/A-CAD,,0,0,0,66210.78,66210.78,66210.78,197906881.20999965,197906881.20999965,ACH,CAD
2025-03-10,Settlement from GoCardless,Processor Payout Batch,SET-20250306-GoCardless-N/A-EUR,,0,0,0,132985.6,132985.6,132985.6,198039866.80999964,198039866.80999964,ACH,EUR
2025-03-10,Settlement from GoCardless,Processor Payout Batch,SET-20250306-GoCardless-N/A-GBP,,0,0,0,103766.06,103766.06,103766.06,198143632.86999965,198143632.86999965,ACH,GBP
2025-03-10,Settlement from PayPal,Processor Payout Batch,SET-20250306-PayPal-N/A-AUD,,0,0,0,74963.87,74963.87,74963.87,198218596.73999965,198218596.73999965,ACH,AUD
2025-03-10,Settlement from PayPal,Processor Payout Batch,SET-20250306-PayPal-N/A-CAD,,0,0,0,76203.21,76203.21,76203.21,198294799.94999966,198294799.94999966,ACH,CAD
2025-03-10,Settlement from PayPal,Processor Payout Batch,SET-20250306-PayPal-N/A-EUR,,0,0,0,179209.48,179209.48,179209.48,198474009.42999965,198474009.42999965,ACH,EUR
2025-03-10,Settlement from PayPal,Processor Payout Batch,SET-20250306-PayPal-N/A-GBP,,0,0,0,108210.32,108210.32,108210.32,198582219.74999964,198582219.74999964,ACH,GBP
2025-03-10,Settlement from ClientLine,Processor Payout Batch,SET-20250306-ClientLine-Visa-USD,,0,0,0,197112.3,197112.3,197112.3,198779332.04999965,198779332.04999965,ACH,USD
2025-03-10,Settlement from PayPal,Processor Payout Batch,SET-20250306-PayPal-N/A-USD,,0,0,0,547059.4,547059.4,547059.4,199326391.44999966,199326391.44999966,ACH,USD
2025-03-10,Settlement from GoCardless,Processor Payout Batch,SET-20250306-GoCardless-N/A-USD,,0,0,0,591929.71,591929.71,591929.71,199918321.15999967,199918321.15999967,ACH,USD
2025-03-10,Settlement from ClientLine,Processor Payout Batch,SET-20250306-ClientLine-Visa-GBP,,0,0,0,36824.69,36824.69,36824.69,199955145.84999967,199955145.84999967,ACH,GBP
2025-03-10,Settlement from ClientLine,Processor Payout Batch,SET-20250306-ClientLine-Mastercard-GBP,,0,0,0,38292.99,38292.99,38292.99,199993438.83999968,199993438.83999968,ACH,GBP
2025-03-10,Settlement from ClientLine,Processor Payout Batch,SET-20250306-ClientLine-Visa-CAD,,0,0,0,5851.66,5851.66,5851.66,199999290.49999967,199999290.49999967,ACH,CAD
2025-03-10,Settlement from Amex,Processor Payout Batch,SET-20250306-Amex-Amex-AUD,,0,0,0,25603.71,25603.71,25603.71,200024894.20999968,200024894.20999968,ACH,AUD
2025-03-10,Settlement from Amex,Processor Payout Batch,SET-20250306-Amex-Amex-CAD,,0,0,0,15888.05,15888.05,15888.05,200040782.2599997,200040782.2599997,ACH,CAD
2025-03-10,Settlement from ClientLine,Processor Payout Batch,SET-20250306-ClientLine-Visa-EUR,,0,0,0,44957.77,44957.77,44957.77,200085740.0299997,200085740.0299997,ACH,EUR
2025-03-10,Settlement from Amex,Processor Payout Batch,SET-20250306-Amex-Amex-GBP,,0,0,0,29047.0,29047.0,29047.0,200114787.0299997,200114787.0299997,ACH,GBP
2025-03-10,Settlement from Amex,Processor Payout Batch,SET-20250306-Amex-Amex-USD,,0,0,0,227911.02,227911.02,227911.02,200342698.0499997,200342698.0499997,ACH,USD
2025-03-10,Settlement from Amex,Processor Payout Batch,SET-20250306-Amex-Amex-EUR,,0,0,0,59449.54,59449.54,59449.54,200402147.5899997,200402147.5899997,ACH,EUR
2025-03-10,Settlement from ClientLine,Processor Payout Batch,SET-20250306-ClientLine-Mastercard-CAD,,0,0,0,28738.61,28738.61,28738.61,200430886.19999972,200430886.19999972,ACH,CAD
2025-03-10,Settlement from ClientLine,Processor Payout Batch,SET-20250306-ClientLine-Mastercard-EUR,,0,0,0,63728.66,63728.66,63728.66,200494614.85999972,200494614.85999972,ACH,EUR
2025-03-10,Settlement from ClientLine,Processor Payout Batch,SET-20250306-ClientLine-Mastercard-USD,,0,0,0,290759.34,290759.34,290759.34,200785374.19999972,200785374.19999972,ACH,USD
2025-03-10,Settlement from ClientLine,Processor Payout Batch,SET-20250306-ClientLine-Visa-AUD,,0,0,0,19528.05,19528.05,19528.05,200804902.24999973,200804902.24999973,ACH,AUD
2025-03-10,Settlement from ClientLine,Processor Payout Batch,SET-20250306-ClientLine-Mastercard-AUD,,0,0,0,22509.2,22509.2,22509.2,200827411.44999972,200827411.44999972,ACH,AUD
2025-03-11,Settlement from GoCardless,Processor Payout Batch,SET-20250307-GoCardless-N/A-GBP,,0,0,0,72542.64,72542.64,72542.64,200899954.0899997,200899954.0899997,ACH,GBP
2025-03-11,Settlement from GoCardless,Processor Payout Batch,SET-20250307-GoCardless-N/A-AUD,,0,0,0,67160.34,67160.34,67160.34,200967114.4299997,200967114.4299997,ACH,AUD
2025-03-11,Settlement from GoCardless,Processor Payout Batch,SET-20250307-GoCardless-N/A-CAD,,0,0,0,52302.3,52302.3,52302.3,201019416.72999972,201019416.72999972,ACH,CAD
2025-03-11,Settlement from GoCardless,Processor Payout Batch,SET-20250307-GoCardless-N/A-EUR,,0,0,0,169446.43,169446.43,169446.43,201188863.15999973,201188863.15999973,ACH,EUR
2025-03-11,Settlement from GoCardless,Processor Payout Batch,SET-20250307-GoCardless-N/A-USD,,0,0,0,552416.14,552416.14,552416.14,201741279.2999997,201741279.2999997,ACH,USD
2025-03-11,Settlement from ClientLine,Processor Payout Batch,SET-20250307-ClientLine-Visa-USD,,0,0,0,171673.98,171673.98,171673.98,201912953.2799997,201912953.2799997,ACH,USD
2025-03-11,Settlement from PayPal,Processor Payout Batch,SET-20250307-PayPal-N/A-CAD,,0,0,0,89199.16,89199.16,89199.16,202002152.4399997,202002152.4399997,ACH,CAD
2025-03-11,Settlement from PayPal,Processor Payout Batch,SET-20250307-PayPal-N/A-EUR,,0,0,0,115620.08,115620.08,115620.08,202117772.5199997,202117772.5199997,ACH,EUR
2025-03-11,Settlement from PayPal,Processor Payout Batch,SET-20250307-PayPal-N/A-GBP,,0,0,0,110590.55,110590.55,110590.55,202228363.06999972,202228363.06999972,ACH,GBP
2025-03-11,Settlement from PayPal,Processor Payout Batch,SET-20250307-PayPal-N/A-USD,,0,0,0,535724.86,535724.86,535724.86,202764087.92999974,202764087.92999974,ACH,USD
2025-03-11,Settlement from PayPal,Processor Payout Batch,SET-20250307-PayPal-N/A-AUD,,0,0,0,76928.54,76928.54,76928.54,202841016.46999973,202841016.46999973,ACH,AUD
2025-03-11,Settlement from ClientLine,Processor Payout Batch,SET-20250307-ClientLine-Visa-GBP,,0,0,0,38631.51,38631.51,38631.51,202879647.97999972,202879647.97999972,ACH,GBP
2025-03-11,Settlement from ClientLine,Processor Payout Batch,SET-20250307-ClientLine-Mastercard-CAD,,0,0,0,25285.58,25285.58,25285.58,202904933.55999973,202904933.55999973,ACH,CAD
2025-03-11,Settlement from ClientLine,Processor Payout Batch,SET-20250307-ClientLine-Visa-CAD,,0,0,0,15973.77,15973.77,15973.77,202920907.32999974,202920907.32999974,ACH,CAD
2025-03-11,Settlement from Amex,Processor Payout Batch,SET-20250307-Amex-Amex-CAD,,0,0,0,24519.27,24519.27,24519.27,202945426.59999976,202945426.59999976,ACH,CAD
2025-03-11,Settlement from Amex,Processor Payout Batch,SET-20250307-Amex-Amex-EUR,,0,0,0,36237.71,36237.71,36237.71,202981664.30999976,202981664.30999976,ACH,EUR
2025-03-11,Settlement from Amex,Processor Payout Batch,SET-20250307-Amex-Amex-GBP,,0,0,0,30676.27,30676.27,30676.27,203012340.57999977,203012340.57999977,ACH,GBP
2025-03-11,Settlement from Amex,Processor Payout Batch,SET-20250307-Amex-Amex-USD,,0,0,0,210939.16,210939.16,210939.16,203223279.73999977,203223279.73999977,ACH,USD
2025-03-11,Settlement from ClientLine,Processor Payout Batch,SET-20250307-ClientLine-Mastercard-AUD,,0,0,0,33610.32,33610.32,33610.32,203256890.05999976,203256890.05999976,ACH,AUD
2025-03-11,Settlement from Amex,Processor Payout Batch,SET-20250307-Amex-Amex-AUD,,0,0,0,20032.64,20032.64,20032.64,203276922.69999975,203276922.69999975,ACH,AUD
2025-03-11,Settlement from ClientLine,Processor Payout Batch,SET-20250307-ClientLine-Mastercard-EUR,,0,0,0,23160.15,23160.15,23160.15,203300082.84999976,203300082.84999976,ACH,EUR
2025-03-11,Settlement from ClientLine,Processor Payout Batch,SET-20250307-ClientLine-Mastercard-GBP,,0,0,0,16833.48,16833.48,16833.48,203316916.32999974,203316916.32999974,ACH,GBP
2025-03-11,Settlement from ClientLine,Processor Payout Batch,SET-20250307-ClientLine-Mastercard-USD,,0,0,0,161740.26,161740.26,161740.26,203478656.58999974,203478656.58999974,ACH,USD
2025-03-11,Settlement from ClientLine,Processor Payout Batch,SET-20250307-ClientLine-Visa-AUD,,0,0,0,38754.43,38754.43,38754.43,203517411.01999974,203517411.01999974,ACH,AUD
2025-03-11,Settlement from ClientLine,Processor Payout Batch,SET-20250307-ClientLine-Visa-EUR,,0,0,0,51765.06,51765.06,51765.06,203569176.07999974,203569176.07999974,ACH,EUR
2025-03-12,Settlement from ClientLine,Processor Payout Batch,SET-20250310-ClientLine-Visa-AUD,,0,0,0,17387.33,17387.33,17387.33,203586563.40999976,203586563.40999976,ACH,AUD
2025-03-12,Settlement from Amex,Processor Payout Batch,SET-20250310-Amex-Amex-CAD,,0,0,0,13098.75,13098.75,13098.75,203599662.15999976,203599662.15999976,ACH,CAD
2025-03-12,Settlement from Amex,Processor Payout Batch,SET-20250310-Amex-Amex-EUR,,0,0,0,61384.65,61384.65,61384.65,203661046.80999976,203661046.80999976,ACH,EUR
2025-03-12,Settlement from Amex,Processor Payout Batch,SET-20250310-Amex-Amex-GBP,,0,0,0,42947.71,42947.71,42947.71,203703994.51999977,203703994.51999977,ACH,GBP
2025-03-12,Settlement from Amex,Processor Payout Batch,SET-20250310-Amex-Amex-USD,,0,0,0,167646.4,167646.4,167646.4,203871640.91999978,203871640.91999978,ACH,USD
2025-03-12,Settlement from ClientLine,Processor Payout Batch,SET-20250310-ClientLine-Mastercard-AUD,,0,0,0,38315.09,38315.09,38315.09,203909956.00999978,203909956.00999978,ACH,AUD
2025-03-12,Settlement from ClientLine,Processor Payout Batch,SET-20250310-ClientLine-Mastercard-CAD,,0,0,0,25237.87,25237.87,25237.87,203935193.8799998,203935193.8799998,ACH,CAD
2025-03-12,Settlement from ClientLine,Processor Payout Batch,SET-20250310-ClientLine-Mastercard-EUR,,0,0,0,64862.97,64862.97,64862.97,204000056.8499998,204000056.8499998,ACH,EUR
2025-03-12,Settlement from ClientLine,Processor Payout Batch,SET-20250310-ClientLine-Mastercard-GBP,,0,0,0,22462.03,22462.03,22462.03,204022518.8799998,204022518.8799998,ACH,GBP
2025-03-12,Settlement from ClientLine,Processor Payout Batch,SET-20250310-ClientLine-Mastercard-USD,,0,0,0,175670.56,175670.56,175670.56,204198189.4399998,204198189.4399998,ACH,USD
2025-03-12,Settlement from ClientLine,Processor Payout Batch,SET-20250310-ClientLine-Visa-CAD,,0,0,0,16302.93,16302.93,16302.93,204214492.3699998,204214492.3699998,ACH,CAD
2025-03-12,Settlement from GoCardless,Processor Payout Batch,SET-20250310-GoCardless-N/A-EUR,,0,0,0,144347.84,144347.84,144347.84,204358840.2099998,204358840.2099998,ACH,EUR
2025-03-12,Settlement from ClientLine,Processor Payout Batch,SET-20250310-ClientLine-Visa-GBP,,0,0,0,44270.12,44270.12,44270.12,204403110.3299998,204403110.3299998,ACH,GBP
2025-03-12,Settlement from ClientLine,Processor Payout Batch,SET-20250310-ClientLine-Visa-USD,,0,0,0,201237.21,201237.21,201237.21,204604347.5399998,204604347.5399998,ACH,USD
2025-03-12,Settlement from GoCardless,Processor Payout Batch,SET-20250310-GoCardless-N/A-AUD,,0,0,0,96550.64,96550.64,96550.64,204700898.1799998,204700898.1799998,ACH,AUD
2025-03-12,Settlement from GoCardless,Processor Payout Batch,SET-20250310-GoCardless-N/A-CAD,,0,0,0,51154.72,51154.72,51154.72,204752052.8999998,204752052.8999998,ACH,CAD
2025-03-12,Settlement from Amex,Processor Payout Batch,SET-20250310-Amex-Amex-AUD,,0,0,0,17443.37,17443.37,17443.37,204769496.2699998,204769496.2699998,ACH,AUD
2025-03-12,Settlement from GoCardless,Processor Payout Batch,SET-20250310-GoCardless-N/A-GBP,,0,0,0,121076.3,121076.3,121076.3,204890572.5699998,204890572.5699998,ACH,GBP
2025-03-12,Settlement from GoCardless,Processor Payout Batch,SET-20250310-GoCardless-N/A-USD,,0,0,0,583900.28,583900.28,583900.28,205474472.84999982,205474472.84999982,ACH,USD
2025-03-12,Settlement from PayPal,Processor Payout Batch,SET-20250310-PayPal-N/A-AUD,,0,0,0,119754.37,119754.37,119754.37,205594227.21999982,205594227.21999982,ACH,AUD
2025-03-12,Settlement from PayPal,Processor Payout Batch,SET-20250310-PayPal-N/A-CAD,,0,0,0,105525.99,105525.99,105525.99,205699753.20999983,205699753.20999983,ACH,CAD
2025-03-12,Settlement from PayPal,Processor Payout Batch,SET-20250310-PayPal-N/A-EUR,,0,0,0,186151.91,186151.91,186151.91,205885905.11999983,205885905.11999983,ACH,EUR
2025-03-12,Settlement from ClientLine,Processor Payout Batch,SET-20250310-ClientLine-Visa-EUR,,0,0,0,44002.6,44002.6,44002.6,205929907.71999982,205929907.71999982,ACH,EUR
2025-03-12,Settlement from PayPal,Processor Payout Batch,SET-20250310-PayPal-N/A-GBP,,0,0,0,123427.94,123427.94,123427.94,206053335.65999982,206053335.65999982,ACH,GBP
2025-03-12,Settlement from PayPal,Processor Payout Batch,SET-20250310-PayPal-N/A-USD,,0,0,0,650158.19,650158.19,650158.19,206703493.84999982,206703493.84999982,ACH,USD
2025-03-12,Settlement from ClientLine,Processor Payout Batch,SET-20250308-ClientLine-Visa-AUD,,0,0,0,19775.07,19775.07,19775.07,206723268.9199998,206723268.9199998,ACH,AUD
2025-03-12,Settlement from PayPal,Processor Payout Batch,SET-20250308-PayPal-N/A-CAD,,0,0,0,79433.23,79433.23,79433.23,206802702.1499998,206802702.1499998,ACH,CAD
2025-03-12,Settlement from PayPal,Processor Payout Batch,SET-20250308-PayPal-N/A-AUD,,0,0,0,75436.27,75436.27,75436.27,206878138.4199998,206878138.4199998,ACH,AUD
2025-03-12,Settlement from GoCardless,Processor Payout Batch,SET-20250308-GoCardless-N/A-USD,,0,0,0,616873.8,616873.8,616873.8,207495012.21999982,207495012.21999982,ACH,USD
2025-03-12,Settlement from GoCardless,Processor Payout Batch,SET-20250308-GoCardless-N/A-GBP,,0,0,0,80382.0,80382.0,80382.0,207575394.21999982,207575394.21999982,ACH,GBP
2025-03-12,Settlement from GoCardless,Processor Payout Batch,SET-20250308-GoCardless-N/A-EUR,,0,0,0,178471.79,178471.79,178471.79,207753866.0099998,207753866.0099998,ACH,EUR
2025-03-12,Settlement from GoCardless,Processor Payout Batch,SET-20250308-GoCardless-N/A-CAD,,0,0,0,61737.76,61737.76,61737.76,207815603.7699998,207815603.7699998,ACH,CAD
2025-03-12,Settlement from GoCardless,Processor Payout Batch,SET-20250308-GoCardless-N/A-AUD,,0,0,0,68127.52,68127.52,68127.52,207883731.2899998,207883731.2899998,ACH,AUD
2025-03-12,Settlement from ClientLine,Processor Payout Batch,SET-20250308-ClientLine-Visa-USD,,0,0,0,233566.5,233566.5,233566.5,208117297.7899998,208117297.7899998,ACH,USD
2025-03-12,Settlement from ClientLine,Processor Payout Batch,SET-20250308-ClientLine-Visa-GBP,,0,0,0,24202.93,24202.93,24202.93,208141500.71999982,208141500.71999982,ACH,GBP
2025-03-12,Settlement from ClientLine,Processor Payout Batch,SET-20250308-ClientLine-Visa-EUR,,0,0,0,71497.31,71497.31,71497.31,208212998.02999982,208212998.02999982,ACH,EUR
2025-03-12,Settlement from ClientLine,Processor Payout Batch,SET-20250308-ClientLine-Visa-CAD,,0,0,0,9630.74,9630.74,9630.74,208222628.76999983,208222628.76999983,ACH,CAD
2025-03-12,Settlement from PayPal,Processor Payout Batch,SET-20250308-PayPal-N/A-EUR,,0,0,0,131801.61,131801.61,131801.61,208354430.37999985,208354430.37999985,ACH,EUR
2025-03-12,Settlement from ClientLine,Processor Payout Batch,SET-20250308-ClientLine-Mastercard-USD,,0,0,0,209105.44,209105.44,209105.44,208563535.81999984,208563535.81999984,ACH,USD
2025-03-12,Settlement from ClientLine,Processor Payout Batch,SET-20250308-ClientLine-Mastercard-GBP,,0,0,0,11331.64,11331.64,11331.64,208574867.45999983,208574867.45999983,ACH,GBP
2025-03-12,Settlement from ClientLine,Processor Payout Batch,SET-20250308-ClientLine-Mastercard-EUR,,0,0,0,39968.07,39968.07,39968.07,208614835.52999982,208614835.52999982,ACH,EUR
2025-03-12,Settlement from ClientLine,Processor Payout Batch,SET-20250308-ClientLine-Mastercard-CAD,,0,0,0,18857.07,18857.07,18857.07,208633692.59999982,208633692.59999982,ACH,CAD
2025-03-12,Settlement from ClientLine,Processor Payout Batch,SET-20250308-ClientLine-Mastercard-AUD,,0,0,0,22441.08,22441.08,22441.08,208656133.67999983,208656133.67999983,ACH,AUD
2025-03-12,Settlement from PayPal,Processor Payout Batch,SET-20250308-PayPal-N/A-GBP,,0,0,0,117421.7,117421.7,117421.7,208773555.37999982,208773555.37999982,ACH,GBP
2025-03-12,Settlement from Amex,Processor Payout Batch,SET-20250308-Amex-Amex-USD,,0,0,0,228299.68,228299.68,228299.68,209001855.05999982,209001855.05999982,ACH,USD
2025-03-12,Settlement from Amex,Processor Payout Batch,SET-20250308-Amex-Amex-GBP,,0,0,0,29808.66,29808.66,29808.66,209031663.71999982,209031663.71999982,ACH,GBP
2025-03-12,Settlement from Amex,Processor Payout Batch,SET-20250308-Amex-Amex-EUR,,0,0,0,55499.02,55499.02,55499.02,209087162.73999983,209087162.73999983,ACH,EUR
2025-03-12,Settlement from Amex,Processor Payout Batch,SET-20250308-Amex-Amex-CAD,,0,0,0,24585.73,24585.73,24585.73,209111748.46999982,209111748.46999982,ACH,CAD
2025-03-12,Settlement from Amex,Processor Payout Batch,SET-20250308-Amex-Amex-AUD,,0,0,0,20074.74,20074.74,20074.74,209131823.20999983,209131823.20999983,ACH,AUD
2025-03-12,Settlement from PayPal,Processor Payout Batch,SET-20250308-PayPal-N/A-USD,,0,0,0,575286.0,575286.0,575286.0,209707109.20999983,209707109.20999983,ACH,USD
2025-03-13,Settlement from PayPal,Processor Payout Batch,SET-20250311-PayPal-N/A-USD,,0,0,0,605970.95,605970.95,605970.95,210313080.15999982,210313080.15999982,ACH,USD
2025-03-13,Settlement from Amex,Processor Payout Batch,SET-20250311-Amex-Amex-AUD,,0,0,0,33460.48,33460.48,33460.48,210346540.6399998,210346540.6399998,ACH,AUD
2025-03-13,Settlement from Amex,Processor Payout Batch,SET-20250311-Amex-Amex-EUR,,0,0,0,36698.6,36698.6,36698.6,210383239.2399998,210383239.2399998,ACH,EUR
2025-03-13,Settlement from PayPal,Processor Payout Batch,SET-20250311-PayPal-N/A-GBP,,0,0,0,115141.2,115141.2,115141.2,210498380.4399998,210498380.4399998,ACH,GBP
2025-03-13,Settlement from PayPal,Processor Payout Batch,SET-20250311-PayPal-N/A-EUR,,0,0,0,153614.08,153614.08,153614.08,210651994.5199998,210651994.5199998,ACH,EUR
2025-03-13,Settlement from PayPal,Processor Payout Batch,SET-20250311-PayPal-N/A-CAD,,0,0,0,81127.49,81127.49,81127.49,210733122.0099998,210733122.0099998,ACH,CAD
2025-03-13,Settlement from PayPal,Processor Payout Batch,SET-20250311-PayPal-N/A-AUD,,0,0,0,95383.26,95383.26,95383.26,210828505.2699998,210828505.2699998,ACH,AUD
2025-03-13,Settlement from GoCardless,Processor Payout Batch,SET-20250311-GoCardless-N/A-USD,,0,0,0,603644.35,603644.35,603644.35,211432149.6199998,211432149.6199998,ACH,USD
2025-03-13,Settlement from GoCardless,Processor Payout Batch,SET-20250311-GoCardless-N/A-EUR,,0,0,0,147634.45,147634.45,147634.45,211579784.06999978,211579784.06999978,ACH,EUR
2025-03-13,Settlement from GoCardless,Processor Payout Batch,SET-20250311-GoCardless-N/A-CAD,,0,0,0,89776.48,89776.48,89776.48,211669560.54999977,211669560.54999977,ACH,CAD
2025-03-13,Settlement from GoCardless,Processor Payout Batch,SET-20250311-GoCardless-N/A-AUD,,0,0,0,70940.26,70940.26,70940.26,211740500.80999976,211740500.80999976,ACH,AUD
2025-03-13,Settlement from ClientLine,Processor Payout Batch,SET-20250311-ClientLine-Visa-USD,,0,0,0,185727.73,185727.73,185727.73,211926228.53999975,211926228.53999975,ACH,USD
2025-03-13,Settlement from Amex,Processor Payout Batch,SET-20250311-Amex-Amex-CAD,,0,0,0,32262.67,32262.67,32262.67,211958491.20999974,211958491.20999974,ACH,CAD
2025-03-13,Settlement from ClientLine,Processor Payout Batch,SET-20250311-ClientLine-Visa-GBP,,0,0,0,38753.03,38753.03,38753.03,211997244.23999974,211997244.23999974,ACH,GBP
2025-03-13,Settlement from ClientLine,Processor Payout Batch,SET-20250311-ClientLine-Visa-CAD,,0,0,0,20705.89,20705.89,20705.89,212017950.12999973,212017950.12999973,ACH,CAD
2025-03-13,Settlement from ClientLine,Processor Payout Batch,SET-20250311-ClientLine-Visa-AUD,,0,0,0,31184.24,31184.24,31184.24,212049134.36999974,212049134.36999974,ACH,AUD
2025-03-13,Settlement from ClientLine,Processor Payout Batch,SET-20250311-ClientLine-Mastercard-USD,,0,0,0,186773.16,186773.16,186773.16,212235907.52999973,212235907.52999973,ACH,USD
2025-03-13,Settlement from ClientLine,Processor Payout Batch,SET-20250311-ClientLine-Mastercard-GBP,,0,0,0,25831.74,25831.74,25831.74,212261739.26999974,212261739.26999974,ACH,GBP
2025-03-13,Settlement from ClientLine,Processor Payout Batch,SET-20250311-ClientLine-Mastercard-EUR,,0,0,0,38966.88,38966.88,38966.88,212300706.14999974,212300706.14999974,ACH,EUR
2025-03-13,Settlement from ClientLine,Processor Payout Batch,SET-20250311-ClientLine-Mastercard-CAD,,0,0,0,24926.66,24926.66,24926.66,212325632.80999973,212325632.80999973,ACH,CAD
2025-03-13,Settlement from ClientLine,Processor Payout Batch,SET-20250311-ClientLine-Mastercard-AUD,,0,0,0,29270.71,29270.71,29270.71,212354903.51999974,212354903.51999974,ACH,AUD
2025-03-13,Settlement from Amex,Processor Payout Batch,SET-20250311-Amex-Amex-USD,,0,0,0,175508.83,175508.83,175508.83,212530412.34999976,212530412.34999976,ACH,USD
2025-03-13,Settlement from Amex,Processor Payout Batch,SET-20250311-Amex-Amex-GBP,,0,0,0,42426.32,42426.32,42426.32,212572838.66999975,212572838.66999975,ACH,GBP
2025-03-13,Settlement from ClientLine,Processor Payout Batch,SET-20250311-ClientLine-Visa-EUR,,0,0,0,74844.5,74844.5,74844.5,212647683.16999975,212647683.16999975,ACH,EUR
2025-03-13,Settlement from GoCardless,Processor Payout Batch,SET-20250311-GoCardless-N/A-GBP,,0,0,0,118336.81,118336.81,118336.81,212766019.97999975,212766019.97999975,ACH,GBP
2025-03-13,Settlement from PayPal,Processor Payout Batch,SET-20250309-PayPal-N/A-USD,,0,0,0,627011.51,627011.51,627011.51,213393031.48999974,213393031.48999974,ACH,USD
2025-03-13,Settlement from PayPal,Processor Payout Batch,SET-20250309-PayPal-N/A-GBP,,0,0,0,103892.34,103892.34,103892.34,213496923.82999974,213496923.82999974,ACH,GBP
2025-03-13,Settlement from Amex,Processor Payout Batch,SET-20250309-Amex-Amex-AUD,,0,0,0,38705.26,38705.26,38705.26,213535629.08999974,213535629.08999974,ACH,AUD
2025-03-13,Settlement from Amex,Processor Payout Batch,SET-20250309-Amex-Amex-CAD,,0,0,0,43986.85,43986.85,43986.85,213579615.93999973,213579615.93999973,ACH,CAD
2025-03-13,Settlement from Amex,Processor Payout Batch,SET-20250309-Amex-Amex-EUR,,0,0,0,47105.83,47105.83,47105.83,213626721.76999974,213626721.76999974,ACH,EUR
2025-03-13,Settlement from Amex,Processor Payout Batch,SET-20250309-Amex-Amex-GBP,,0,0,0,29785.59,29785.59,29785.59,213656507.35999975,213656507.35999975,ACH,GBP
2025-03-13,Settlement from Amex,Processor Payout Batch,SET-20250309-Amex-Amex-USD,,0,0,0,238008.85,238008.85,238008.85,213894516.20999974,213894516.20999974,ACH,USD
2025-03-13,Settlement from ClientLine,Processor Payout Batch,SET-20250309-ClientLine-Mastercard-AUD,,0,0,0,19775.34,19775.34,19775.34,213914291.54999974,213914291.54999974,ACH,AUD
2025-03-13,Settlement from ClientLine,Processor Payout Batch,SET-20250309-ClientLine-Mastercard-EUR,,0,0,0,46078.25,46078.25,46078.25,213960369.79999974,213960369.79999974,ACH,EUR
2025-03-13,Settlement from ClientLine,Processor Payout Batch,SET-20250309-ClientLine-Mastercard-GBP,,0,0,0,28702.62,28702.62,28702.62,213989072.41999975,213989072.41999975,ACH,GBP
2025-03-13,Settlement from ClientLine,Processor Payout Batch,SET-20250309-ClientLine-Mastercard-USD,,0,0,0,173906.79,173906.79,173906.79,214162979.20999974,214162979.20999974,ACH,USD
2025-03-13,Settlement from ClientLine,Processor Payout Batch,SET-20250309-ClientLine-Visa-AUD,,0,0,0,37347.35,37347.35,37347.35,214200326.55999973,214200326.55999973,ACH,AUD
2025-03-13,Settlement from ClientLine,Processor Payout Batch,SET-20250309-ClientLine-Visa-CAD,,0,0,0,22780.86,22780.86,22780.86,214223107.41999975,214223107.41999975,ACH,CAD
2025-03-13,Settlement from ClientLine,Processor Payout Batch,SET-20250309-ClientLine-Mastercard-CAD,,0,0,0,14060.78,14060.78,14060.78,214237168.19999975,214237168.19999975,ACH,CAD
2025-03-13,Settlement from ClientLine,Processor Payout Batch,SET-20250309-ClientLine-Visa-GBP,,0,0,0,33751.88,33751.88,33751.88,214270920.07999974,214270920.07999974,ACH,GBP
2025-03-13,Settlement from ClientLine,Processor Payout Batch,SET-20250309-ClientLine-Visa-USD,,0,0,0,165340.07,165340.07,165340.07,214436260.14999974,214436260.14999974,ACH,USD
2025-03-13,Settlement from GoCardless,Processor Payout Batch,SET-20250309-GoCardless-N/A-AUD,,0,0,0,66892.7,66892.7,66892.7,214503152.84999973,214503152.84999973,ACH,AUD
2025-03-13,Settlement from GoCardless,Processor Payout Batch,SET-20250309-GoCardless-N/A-CAD,,0,0,0,78784.91,78784.91,78784.91,214581937.75999972,214581937.75999972,ACH,CAD
2025-03-13,Settlement from GoCardless,Processor Payout Batch,SET-20250309-GoCardless-N/A-EUR,,0,0,0,173437.42,173437.42,173437.42,214755375.1799997,214755375.1799997,ACH,EUR
2025-03-13,Settlement from GoCardless,Processor Payout Batch,SET-20250309-GoCardless-N/A-GBP,,0,0,0,124551.06,124551.06,124551.06,214879926.2399997,214879926.2399997,ACH,GBP
2025-03-13,Settlement from GoCardless,Processor Payout Batch,SET-20250309-GoCardless-N/A-USD,,0,0,0,588184.94,588184.94,588184.94,215468111.1799997,215468111.1799997,ACH,USD
2025-03-13,Settlement from PayPal,Processor Payout Batch,SET-20250309-PayPal-N/A-AUD,,0,0,0,118939.73,118939.73,118939.73,215587050.9099997,215587050.9099997,ACH,AUD
2025-03-13,Settlement from PayPal,Processor Payout Batch,SET-20250309-PayPal-N/A-CAD,,0,0,0,89010.13,89010.13,89010.13,215676061.0399997,215676061.0399997,ACH,CAD
2025-03-13,Settlement from PayPal,Processor Payout Batch,SET-20250309-PayPal-N/A-EUR,,0,0,0,132009.82,132009.82,132009.82,215808070.8599997,215808070.8599997,ACH,EUR
2025-03-13,Settlement from ClientLine,Processor Payout Batch,SET-20250309-ClientLine-Visa-EUR,,0,0,0,41312.12,41312.12,41312.12,215849382.9799997,215849382.9799997,ACH,EUR
2025-03-14,Settlement from ClientLine,Processor Payout Batch,SET-20250312-ClientLine-Visa-USD,,0,0,0,189903.88,189903.88,189903.88,216039286.8599997,216039286.8599997,ACH,USD
2025-03-14,Settlement from GoCardless,Processor Payout Batch,SET-20250312-GoCardless-N/A-AUD,,0,0,0,104909.64,104909.64,104909.64,216144196.49999967,216144196.49999967,ACH,AUD
2025-03-14,Settlement from GoCardless,Processor Payout Batch,SET-20250312-GoCardless-N/A-CAD,,0,0,0,62885.21,62885.21,62885.21,216207081.70999968,216207081.70999968,ACH,CAD
2025-03-14,Settlement from GoCardless,Processor Payout Batch,SET-20250312-GoCardless-N/A-EUR,,0,0,0,116340.52,116340.52,116340.52,216323422.2299997,216323422.2299997,ACH,EUR
2025-03-14,Settlement from GoCardless,Processor Payout Batch,SET-20250312-GoCardless-N/A-USD,,0,0,0,641484.15,641484.15,641484.15,216964906.3799997,216964906.3799997,ACH,USD
2025-03-14,Settlement from PayPal,Processor Payout Batch,SET-20250312-PayPal-N/A-USD,,0,0,0,639711.13,639711.13,639711.13,217604617.5099997,217604617.5099997,ACH,USD
2025-03-14,Settlement from PayPal,Processor Payout Batch,SET-20250312-PayPal-N/A-CAD,,0,0,0,79986.0,79986.0,79986.0,217684603.5099997,217684603.5099997,ACH,CAD
2025-03-14,Settlement from PayPal,Processor Payout Batch,SET-20250312-PayPal-N/A-EUR,,0,0,0,146933.16,146933.16,146933.16,217831536.6699997,217831536.6699997,ACH,EUR
2025-03-14,Settlement from PayPal,Processor Payout Batch,SET-20250312-PayPal-N/A-GBP,,0,0,0,93049.54,93049.54,93049.54,217924586.20999968,217924586.20999968,ACH,GBP
2025-03-14,Settlement from ClientLine,Processor Payout Batch,SET-20250312-ClientLine-Visa-GBP,,0,0,0,19454.56,19454.56,19454.56,217944040.76999968,217944040.76999968,ACH,GBP
2025-03-14,Settlement from PayPal,Processor Payout Batch,SET-20250312-PayPal-N/A-AUD,,0,0,0,106301.61,106301.61,106301.61,218050342.3799997,218050342.3799997,ACH,AUD
2025-03-14,Settlement from ClientLine,Processor Payout Batch,SET-20250312-ClientLine-Visa-EUR,,0,0,0,30730.47,30730.47,30730.47,218081072.8499997,218081072.8499997,ACH,EUR
2025-03-14,Settlement from GoCardless,Processor Payout Batch,SET-20250312-GoCardless-N/A-GBP,,0,0,0,114069.81,114069.81,114069.81,218195142.6599997,218195142.6599997,ACH,GBP
2025-03-14,Settlement from ClientLine,Processor Payout Batch,SET-20250312-ClientLine-Visa-AUD,,0,0,0,28722.31,28722.31,28722.31,218223864.9699997,218223864.9699997,ACH,AUD
2025-03-14,Settlement from Amex,Processor Payout Batch,SET-20250312-Amex-Amex-CAD,,0,0,0,33616.99,33616.99,33616.99,218257481.9599997,218257481.9599997,ACH,CAD
2025-03-14,Settlement from Amex,Processor Payout Batch,SET-20250312-Amex-Amex-EUR,,0,0,0,56198.57,56198.57,56198.57,218313680.5299997,218313680.5299997,ACH,EUR
2025-03-14,Settlement from Amex,Processor Payout Batch,SET-20250312-Amex-Amex-GBP,,0,0,0,31723.78,31723.78,31723.78,218345404.3099997,218345404.3099997,ACH,GBP
2025-03-14,Settlement from Amex,Processor Payout Batch,SET-20250312-Amex-Amex-USD,,0,0,0,190366.47,190366.47,190366.47,218535770.7799997,218535770.7799997,ACH,USD
2025-03-14,Settlement from ClientLine,Processor Payout Batch,SET-20250312-ClientLine-Mastercard-AUD,,0,0,0,23711.04,23711.04,23711.04,218559481.8199997,218559481.8199997,ACH,AUD
2025-03-14,Settlement from Amex,Processor Payout Batch,SET-20250312-Amex-Amex-AUD,,0,0,0,30858.76,30858.76,30858.76,218590340.5799997,218590340.5799997,ACH,AUD
2025-03-14,Settlement from ClientLine,Processor Payout Batch,SET-20250312-ClientLine-Mastercard-CAD,,0,0,0,20852.03,20852.03,20852.03,218611192.6099997,218611192.6099997,ACH,CAD
2025-03-14,Settlement from ClientLine,Processor Payout Batch,SET-20250312-ClientLine-Mastercard-EUR,,0,0,0,62492.71,62492.71,62492.71,218673685.3199997,218673685.3199997,ACH,EUR
2025-03-14,Settlement from ClientLine,Processor Payout Batch,SET-20250312-ClientLine-Mastercard-GBP,,0,0,0,54383.41,54383.41,54383.41,218728068.7299997,218728068.7299997,ACH,GBP
2025-03-14,Settlement from ClientLine,Processor Payout Batch,SET-20250312-ClientLine-Mastercard-USD,,0,0,0,211620.73,211620.73,211620.73,218939689.45999968,218939689.45999968,ACH,USD
2025-03-14,Settlement from ClientLine,Processor Payout Batch,SET-20250312-ClientLine-Visa-CAD,,0,0,0,15580.63,15580.63,15580.63,218955270.08999968,218955270.08999968,ACH,CAD
2025-03-17,Settlement from GoCardless,Processor Payout Batch,SET-20250313-GoCardless-N/A-AUD,,0,0,0,72547.55,72547.55,72547.55,219027817.6399997,219027817.6399997,ACH,AUD
2025-03-17,Settlement from GoCardless,Processor Payout Batch,SET-20250313-GoCardless-N/A-CAD,,0,0,0,68833.79,68833.79,68833.79,219096651.42999968,219096651.42999968,ACH,CAD
2025-03-17,Settlement from GoCardless,Processor Payout Batch,SET-20250313-GoCardless-N/A-EUR,,0,0,0,123270.33,123270.33,123270.33,219219921.7599997,219219921.7599997,ACH,EUR
2025-03-17,Settlement from GoCardless,Processor Payout Batch,SET-20250313-GoCardless-N/A-GBP,,0,0,0,94846.15,94846.15,94846.15,219314767.9099997,219314767.9099997,ACH,GBP
2025-03-17,Settlement from GoCardless,Processor Payout Batch,SET-20250313-GoCardless-N/A-USD,,0,0,0,697204.32,697204.32,697204.32,220011972.2299997,220011972.2299997,ACH,USD
2025-03-17,Settlement from PayPal,Processor Payout Batch,SET-20250313-PayPal-N/A-CAD,,0,0,0,74768.78,74768.78,74768.78,220086741.0099997,220086741.0099997,ACH,CAD
2025-03-17,Settlement from PayPal,Processor Payout Batch,SET-20250313-PayPal-N/A-EUR,,0,0,0,158300.22,158300.22,158300.22,220245041.2299997,220245041.2299997,ACH,EUR
2025-03-17,Settlement from PayPal,Processor Payout Batch,SET-20250313-PayPal-N/A-GBP,,0,0,0,90634.91,90634.91,90634.91,220335676.1399997,220335676.1399997,ACH,GBP
2025-03-17,Settlement from PayPal,Processor Payout Batch,SET-20250313-PayPal-N/A-USD,,0,0,0,635453.59,635453.59,635453.59,220971129.7299997,220971129.7299997,ACH,USD
2025-03-17,Settlement from ClientLine,Processor Payout Batch,SET-20250313-ClientLine-Visa-USD,,0,0,0,212085.72,212085.72,212085.72,221183215.4499997,221183215.4499997,ACH,USD
2025-03-17,Settlement from PayPal,Processor Payout Batch,SET-20250313-PayPal-N/A-AUD,,0,0,0,81778.32,81778.32,81778.32,221264993.76999968,221264993.76999968,ACH,AUD
2025-03-17,Settlement from ClientLine,Processor Payout Batch,SET-20250313-ClientLine-Visa-GBP,,0,0,0,32888.38,32888.38,32888.38,221297882.14999968,221297882.14999968,ACH,GBP
2025-03-17,Settlement from ClientLine,Processor Payout Batch,SET-20250313-ClientLine-Visa-EUR,,0,0,0,49886.49,49886.49,49886.49,221347768.6399997,221347768.6399997,ACH,EUR
2025-03-17,Settlement from ClientLine,Processor Payout Batch,SET-20250313-ClientLine-Visa-CAD,,0,0,0,23442.76,23442.76,23442.76,221371211.39999968,221371211.39999968,ACH,CAD
2025-03-17,Settlement from Amex,Processor Payout Batch,SET-20250313-Amex-Amex-CAD,,0,0,0,37726.34,37726.34,37726.34,221408937.73999968,221408937.73999968,ACH,CAD
2025-03-17,Settlement from Amex,Processor Payout Batch,SET-20250313-Amex-Amex-EUR,,0,0,0,62684.24,62684.24,62684.24,221471621.9799997,221471621.9799997,ACH,EUR
2025-03-17,Settlement from Amex,Processor Payout Batch,SET-20250313-Amex-Amex-GBP,,0,0,0,42201.42,42201.42,42201.42,221513823.39999968,221513823.39999968,ACH,GBP
2025-03-17,Settlement from Amex,Processor Payout Batch,SET-20250313-Amex-Amex-USD,,0,0,0,226365.22,226365.22,226365.22,221740188.61999968,221740188.61999968,ACH,USD
2025-03-17,Settlement from ClientLine,Processor Payout Batch,SET-20250313-ClientLine-Mastercard-AUD,,0,0,0,33015.78,33015.78,33015.78,221773204.39999968,221773204.39999968,ACH,AUD
2025-03-17,Settlement from Amex,Processor Payout Batch,SET-20250313-Amex-Amex-AUD,,0,0,0,35432.62,35432.62,35432.62,221808637.01999968,221808637.01999968,ACH,AUD
2025-03-17,Settlement from ClientLine,Processor Payout Batch,SET-20250313-ClientLine-Mastercard-EUR,,0,0,0,52111.68,52111.68,52111.68,221860748.6999997,221860748.6999997,ACH,EUR
2025-03-17,Settlement from ClientLine,Processor Payout Batch,SET-20250313-ClientLine-Mastercard-GBP,,0,0,0,25888.34,25888.34,25888.34,221886637.0399997,221886637.0399997,ACH,GBP
2025-03-17,Settlement from ClientLine,Processor Payout Batch,SET-20250313-ClientLine-Mastercard-USD,,0,0,0,200660.42,200660.42,200660.42,222087297.45999968,222087297.45999968,ACH,USD
2025-03-17,Settlement from ClientLine,Processor Payout Batch,SET-20250313-ClientLine-Visa-AUD,,0,0,0,34386.95,34386.95,34386.95,222121684.40999967,222121684.40999967,ACH,AUD
2025-03-17,Settlement from ClientLine,Processor Payout Batch,SET-20250313-ClientLine-Mastercard-CAD,,0,0,0,16786.68,16786.68,16786.68,222138471.08999968,222138471.08999968,ACH,CAD
2025-03-18,Settlement from GoCardless,Processor Payout Batch,SET-20250314-GoCardless-N/A-AUD,,0,0,0,49870.84,49870.84,49870.84,222188341.92999968,222188341.92999968,ACH,AUD
2025-03-18,Settlement from GoCardless,Processor Payout Batch,SET-20250314-GoCardless-N/A-CAD,,0,0,0,90186.77,90186.77,90186.77,222278528.6999997,222278528.6999997,ACH,CAD
2025-03-18,Settlement from GoCardless,Processor Payout Batch,SET-20250314-GoCardless-N/A-EUR,,0,0,0,153714.74,153714.74,153714.74,222432243.4399997,222432243.4399997,ACH,EUR
2025-03-18,Settlement from GoCardless,Processor Payout Batch,SET-20250314-GoCardless-N/A-GBP,,0,0,0,107386.15,107386.15,107386.15,222539629.5899997,222539629.5899997,ACH,GBP
2025-03-18,Settlement from GoCardless,Processor Payout Batch,SET-20250314-GoCardless-N/A-USD,,0,0,0,582745.19,582745.19,582745.19,223122374.7799997,223122374.7799997,ACH,USD
2025-03-18,Settlement from PayPal,Processor Payout Batch,SET-20250314-PayPal-N/A-CAD,,0,0,0,89259.63,89259.63,89259.63,223211634.4099997,223211634.4099997,ACH,CAD
2025-03-18,Settlement from PayPal,Processor Payout Batch,SET-20250314-PayPal-N/A-EUR,,0,0,0,177156.03,177156.03,177156.03,223388790.4399997,223388790.4399997,ACH,EUR
2025-03-18,Settlement from PayPal,Processor Payout Batch,SET-20250314-PayPal-N/A-GBP,,0,0,0,92188.6,92188.6,92188.6,223480979.0399997,223480979.0399997,ACH,GBP
2025-03-18,Settlement from PayPal,Processor Payout Batch,SET-20250314-PayPal-N/A-USD,,0,0,0,677149.72,677149.72,677149.72,224158128.7599997,224158128.7599997,ACH,USD
2025-03-18,Settlement from ClientLine,Processor Payout Batch,SET-20250314-ClientLine-Visa-USD,,0,0,0,218544.14,218544.14,218544.14,224376672.89999968,224376672.89999968,ACH,USD
2025-03-18,Settlement from PayPal,Processor Payout Batch,SET-20250314-PayPal-N/A-AUD,,0,0,0,57031.37,57031.37,57031.37,224433704.26999968,224433704.26999968,ACH,AUD
2025-03-18,Settlement from ClientLine,Processor Payout Batch,SET-20250314-ClientLine-Visa-GBP,,0,0,0,27580.31,27580.31,27580.31,224461284.5799997,224461284.5799997,ACH,GBP
2025-03-18,Settlement from ClientLine,Processor Payout Batch,SET-20250314-ClientLine-Mastercard-AUD,,0,0,0,26462.31,26462.31,26462.31,224487746.8899997,224487746.8899997,ACH,AUD
2025-03-18,Settlement from ClientLine,Processor Payout Batch,SET-20250314-ClientLine-Visa-CAD,,0,0,0,28261.2,28261.2,28261.2,224516008.08999968,224516008.08999968,ACH,CAD
2025-03-18,Settlement from ClientLine,Processor Payout Batch,SET-20250314-ClientLine-Visa-EUR,,0,0,0,40502.6,40502.6,40502.6,224556510.68999967,224556510.68999967,ACH,EUR
2025-03-18,Settlement from Amex,Processor Payout Batch,SET-20250314-Amex-Amex-CAD,,0,0,0,23066.05,23066.05,23066.05,224579576.73999968,224579576.73999968,ACH,CAD
2025-03-18,Settlement from Amex,Processor Payout Batch,SET-20250314-Amex-Amex-EUR,,0,0,0,69979.22,69979.22,69979.22,224649555.95999968,224649555.95999968,ACH,EUR
2025-03-18,Settlement from Amex,Processor Payout Batch,SET-20250314-Amex-Amex-GBP,,0,0,0,38207.71,38207.71,38207.71,224687763.6699997,224687763.6699997,ACH,GBP
2025-03-18,Settlement from Amex,Processor Payout Batch,SET-20250314-Amex-Amex-USD,,0,0,0,159773.9,159773.9,159773.9,224847537.5699997,224847537.5699997,ACH,USD
2025-03-18,Settlement from Amex,Processor Payout Batch,SET-20250314-Amex-Amex-AUD,,0,0,0,19780.73,19780.73,19780.73,224867318.29999968,224867318.29999968,ACH,AUD
2025-03-18,Settlement from ClientLine,Processor Payout Batch,SET-20250314-ClientLine-Mastercard-CAD,,0,0,0,28755.86,28755.86,28755.86,224896074.1599997,224896074.1599997,ACH,CAD
2025-03-18,Settlement from ClientLine,Processor Payout Batch,SET-20250314-ClientLine-Mastercard-EUR,,0,0,0,56597.25,56597.25,56597.25,224952671.4099997,224952671.4099997,ACH,EUR
2025-03-18,Settlement from ClientLine,Processor Payout Batch,SET-20250314-ClientLine-Mastercard-GBP,,0,0,0,20264.96,20264.96,20264.96,224972936.3699997,224972936.3699997,ACH,GBP
2025-03-18,Settlement from ClientLine,Processor Payout Batch,SET-20250314-ClientLine-Mastercard-USD,,0,0,0,208029.43,208029.43,208029.43,225180965.7999997,225180965.7999997,ACH,USD
2025-03-18,Settlement from ClientLine,Processor Payout Batch,SET-20250314-ClientLine-Visa-AUD,,0,0,0,43104.12,43104.12,43104.12,225224069.91999972,225224069.91999972,ACH,AUD
2025-03-19,Settlement from ClientLine,Processor Payout Batch,SET-20250317-ClientLine-Mastercard-USD,,0,0,0,208006.12,208006.12,208006.12,225432076.03999972,225432076.03999972,ACH,USD
2025-03-19,Settlement from Amex,Processor Payout Batch,SET-20250317-Amex-Amex-CAD,,0,0,0,24722.32,24722.32,24722.32,225456798.35999972,225456798.35999972,ACH,CAD
2025-03-19,Settlement from Amex,Processor Payout Batch,SET-20250317-Amex-Amex-EUR,,0,0,0,23558.71,23558.71,23558.71,225480357.06999972,225480357.06999972,ACH,EUR
2025-03-19,Settlement from Amex,Processor Payout Batch,SET-20250317-Amex-Amex-GBP,,0,0,0,32218.32,32218.32,32218.32,225512575.38999972,225512575.38999972,ACH,GBP
2025-03-19,Settlement from Amex,Processor Payout Batch,SET-20250317-Amex-Amex-USD,,0,0,0,212087.82,212087.82,212087.82,225724663.2099997,225724663.2099997,ACH,USD
2025-03-19,Settlement from ClientLine,Processor Payout Batch,SET-20250317-ClientLine-Mastercard-AUD,,0,0,0,39988.28,39988.28,39988.28,225764651.4899997,225764651.4899997,ACH,AUD
2025-03-19,Settlement from ClientLine,Processor Payout Batch,SET-20250317-ClientLine-Mastercard-CAD,,0,0,0,25126.27,25126.27,25126.27,225789777.75999972,225789777.75999972,ACH,CAD
2025-03-19,Settlement from ClientLine,Processor Payout Batch,SET-20250317-ClientLine-Mastercard-EUR,,0,0,0,55788.21,55788.21,55788.21,225845565.96999973,225845565.96999973,ACH,EUR
2025-03-19,Settlement from ClientLine,Processor Payout Batch,SET-20250317-ClientLine-Mastercard-GBP,,0,0,0,22364.46,22364.46,22364.46,225867930.42999974,225867930.42999974,ACH,GBP
2025-03-19,Settlement from Amex,Processor Payout Batch,SET-20250317-Amex-Amex-AUD,,0,0,0,41122.98,41122.98,41122.98,225909053.40999973,225909053.40999973,ACH,AUD
2025-03-19,Settlement from ClientLine,Processor Payout Batch,SET-20250317-ClientLine-Visa-AUD,,0,0,0,30237.89,30237.89,30237.89,225939291.2999997,225939291.2999997,ACH,AUD
2025-03-19,Settlement from PayPal,Processor Payout Batch,SET-20250317-PayPal-N/A-CAD,,0,0,0,67956.34,67956.34,67956.34,226007247.63999972,226007247.63999972,ACH,CAD
2025-03-19,Settlement from ClientLine,Processor Payout Batch,SET-20250317-ClientLine-Visa-EUR,,0,0,0,68534.38,68534.38,68534.38,226075782.0199997,226075782.0199997,ACH,EUR
2025-03-19,Settlement from ClientLine,Processor Payout Batch,SET-20250317-ClientLine-Visa-GBP,,0,0,0,34238.7,34238.7,34238.7,226110020.7199997,226110020.7199997,ACH,GBP
2025-03-19,Settlement from ClientLine,Processor Payout Batch,SET-20250317-ClientLine-Visa-USD,,0,0,0,234729.56,234729.56,234729.56,226344750.2799997,226344750.2799997,ACH,USD
2025-03-19,Settlement from GoCardless,Processor Payout Batch,SET-20250317-GoCardless-N/A-AUD,,0,0,0,70483.85,70483.85,70483.85,226415234.1299997,226415234.1299997,ACH,AUD
2025-03-19,Settlement from GoCardless,Processor Payout Batch,SET-20250317-GoCardless-N/A-CAD,,0,0,0,61455.98,61455.98,61455.98,226476690.1099997,226476690.1099997,ACH,CAD
2025-03-19,Settlement from GoCardless,Processor Payout Batch,SET-20250317-GoCardless-N/A-EUR,,0,0,0,153494.62,153494.62,153494.62,226630184.7299997,226630184.7299997,ACH,EUR
2025-03-19,Settlement from GoCardless,Processor Payout Batch,SET-20250317-GoCardless-N/A-GBP,,0,0,0,91848.31,91848.31,91848.31,226722033.0399997,226722033.0399997,ACH,GBP
2025-03-19,Settlement from GoCardless,Processor Payout Batch,SET-20250317-GoCardless-N/A-USD,,0,0,0,637301.93,637301.93,637301.93,227359334.9699997,227359334.9699997,ACH,USD
2025-03-19,Settlement from PayPal,Processor Payout Batch,SET-20250317-PayPal-N/A-AUD,,0,0,0,73400.44,73400.44,73400.44,227432735.4099997,227432735.4099997,ACH,AUD
2025-03-19,Settlement from PayPal,Processor Payout Batch,SET-20250317-PayPal-N/A-USD,,0,0,0,688810.13,688810.13,688810.13,228121545.5399997,228121545.5399997,ACH,USD
2025-03-19,Settlement from ClientLine,Processor Payout Batch,SET-20250317-ClientLine-Visa-CAD,,0,0,0,20960.18,20960.18,20960.18,228142505.7199997,228142505.7199997,ACH,CAD
2025-03-19,Settlement from PayPal,Processor Payout Batch,SET-20250315-PayPal-N/A-USD,,0,0,0,612008.05,612008.05,612008.05,228754513.7699997,228754513.7699997,ACH,USD
2025-03-19,Settlement from ClientLine,Processor Payout Batch,SET-20250315-ClientLine-Mastercard-AUD,,0,0,0,24835.08,24835.08,24835.08,228779348.84999973,228779348.84999973,ACH,AUD
2025-03-19,Settlement from PayPal,Processor Payout Batch,SET-20250315-PayPal-N/A-EUR,,0,0,0,107574.36,107574.36,107574.36,228886923.20999974,228886923.20999974,ACH,EUR
2025-03-19,Settlement from PayPal,Processor Payout Batch,SET-20250315-PayPal-N/A-AUD,,0,0,0,73969.33,73969.33,73969.33,228960892.53999975,228960892.53999975,ACH,AUD
2025-03-19,Settlement from GoCardless,Processor Payout Batch,SET-20250315-GoCardless-N/A-USD,,0,0,0,623636.85,623636.85,623636.85,229584529.38999975,229584529.38999975,ACH,USD
2025-03-19,Settlement from GoCardless,Processor Payout Batch,SET-20250315-GoCardless-N/A-GBP,,0,0,0,64695.35,64695.35,64695.35,229649224.73999974,229649224.73999974,ACH,GBP
2025-03-19,Settlement from GoCardless,Processor Payout Batch,SET-20250315-GoCardless-N/A-EUR,,0,0,0,196046.68,196046.68,196046.68,229845271.41999975,229845271.41999975,ACH,EUR
2025-03-19,Settlement from GoCardless,Processor Payout Batch,SET-20250315-GoCardless-N/A-CAD,,0,0,0,68005.58,68005.58,68005.58,229913276.99999976,229913276.99999976,ACH,CAD
2025-03-19,Settlement from GoCardless,Processor Payout Batch,SET-20250315-GoCardless-N/A-AUD,,0,0,0,76368.14,76368.14,76368.14,229989645.13999975,229989645.13999975,ACH,AUD
2025-03-19,Settlement from ClientLine,Processor Payout Batch,SET-20250315-ClientLine-Visa-USD,,0,0,0,184115.02,184115.02,184115.02,230173760.15999976,230173760.15999976,ACH,USD
2025-03-19,Settlement from ClientLine,Processor Payout Batch,SET-20250315-ClientLine-Visa-GBP,,0,0,0,35210.3,35210.3,35210.3,230208970.45999977,230208970.45999977,ACH,GBP
2025-03-19,Settlement from ClientLine,Processor Payout Batch,SET-20250315-ClientLine-Visa-EUR,,0,0,0,38861.22,38861.22,38861.22,230247831.67999977,230247831.67999977,ACH,EUR
2025-03-19,Settlement from ClientLine,Processor Payout Batch,SET-20250315-ClientLine-Visa-CAD,,0,0,0,10714.55,10714.55,10714.55,230258546.22999978,230258546.22999978,ACH,CAD
2025-03-19,Settlement from ClientLine,Processor Payout Batch,SET-20250315-ClientLine-Visa-AUD,,0,0,0,27691.71,27691.71,27691.71,230286237.9399998,230286237.9399998,ACH,AUD
2025-03-19,Settlement from ClientLine,Processor Payout Batch,SET-20250315-ClientLine-Mastercard-USD,,0,0,0,209919.92,209919.92,209919.92,230496157.85999978,230496157.85999978,ACH,USD
2025-03-19,Settlement from ClientLine,Processor Payout Batch,SET-20250315-ClientLine-Mastercard-GBP,,0,0,0,16546.63,16546.63,16546.63,230512704.48999977,230512704.48999977,ACH,GBP
2025-03-19,Settlement from ClientLine,Processor Payout Batch,SET-20250315-ClientLine-Mastercard-EUR,,0,0,0,38086.18,38086.18,38086.18,230550790.66999978,230550790.66999978,ACH,EUR
2025-03-19,Settlement from ClientLine,Processor Payout Batch,SET-20250315-ClientLine-Mastercard-CAD,,0,0,0,25808.72,25808.72,25808.72,230576599.38999978,230576599.38999978,ACH,CAD
2025-03-19,Settlement from Amex,Processor Payout Batch,SET-20250315-Amex-Amex-USD,,0,0,0,260918.05,260918.05,260918.05,230837517.4399998,230837517.4399998,ACH,USD
2025-03-19,Settlement from Amex,Processor Payout Batch,SET-20250315-Amex-Amex-GBP,,0,0,0,54519.26,54519.26,54519.26,230892036.69999978,230892036.69999978,ACH,GBP
2025-03-19,Settlement from Amex,Processor Payout Batch,SET-20250315-Amex-Amex-EUR,,0,0,0,67923.87,67923.87,67923.87,230959960.56999978,230959960.56999978,ACH,EUR
2025-03-19,Settlement from Amex,Processor Payout Batch,SET-20250315-Amex-Amex-CAD,,0,0,0,8551.64,8551.64,8551.64,230968512.20999977,230968512.20999977,ACH,CAD
2025-03-19,Settlement from Amex,Processor Payout Batch,SET-20250315-Amex-Amex-AUD,,0,0,0,28279.48,28279.48,28279.48,230996791.68999976,230996791.68999976,ACH,AUD
2025-03-19,Settlement from PayPal,Processor Payout Batch,SET-20250317-PayPal-N/A-EUR,,0,0,0,162648.67,162648.67,162648.67,231159440.35999975,231159440.35999975,ACH,EUR
2025-03-19,Settlement from PayPal,Processor Payout Batch,SET-20250315-PayPal-N/A-CAD,,0,0,0,71975.41,71975.41,71975.41,231231415.76999974,231231415.76999974,ACH,CAD
2025-03-19,Settlement from PayPal,Processor Payout Batch,SET-20250315-PayPal-N/A-GBP,,0,0,0,112347.57,112347.57,112347.57,231343763.33999974,231343763.33999974,ACH,GBP
2025-03-19,Settlement from PayPal,Processor Payout Batch,SET-20250317-PayPal-N/A-GBP,,0,0,0,123422.02,123422.02,123422.02,231467185.35999975,231467185.35999975,ACH,GBP
2025-03-20,Settlement from Amex,Processor Payout Batch,SET-20250318-Amex-Amex-CAD,,0,0,0,15240.35,15240.35,15240.35,231482425.70999974,231482425.70999974,ACH,CAD
2025-03-20,Settlement from PayPal,Processor Payout Batch,SET-20250318-PayPal-N/A-EUR,,0,0,0,124554.66,124554.66,124554.66,231606980.36999974,231606980.36999974,ACH,EUR
2025-03-20,Settlement from PayPal,Processor Payout Batch,SET-20250318-PayPal-N/A-CAD,,0,0,0,75834.35,75834.35,75834.35,231682814.71999973,231682814.71999973,ACH,CAD
2025-03-20,Settlement from PayPal,Processor Payout Batch,SET-20250318-PayPal-N/A-AUD,,0,0,0,81236.16,81236.16,81236.16,231764050.87999973,231764050.87999973,ACH,AUD
2025-03-20,Settlement from GoCardless,Processor Payout Batch,SET-20250318-GoCardless-N/A-USD,,0,0,0,633492.55,633492.55,633492.55,232397543.42999974,232397543.42999974,ACH,USD
2025-03-20,Settlement from GoCardless,Processor Payout Batch,SET-20250318-GoCardless-N/A-GBP,,0,0,0,113854.86,113854.86,113854.86,232511398.28999975,232511398.28999975,ACH,GBP
2025-03-20,Settlement from GoCardless,Processor Payout Batch,SET-20250318-GoCardless-N/A-EUR,,0,0,0,173077.5,173077.5,173077.5,232684475.78999975,232684475.78999975,ACH,EUR
2025-03-20,Settlement from GoCardless,Processor Payout Batch,SET-20250318-GoCardless-N/A-CAD,,0,0,0,95051.33,95051.33,95051.33,232779527.11999977,232779527.11999977,ACH,CAD
2025-03-20,Settlement from GoCardless,Processor Payout Batch,SET-20250318-GoCardless-N/A-AUD,,0,0,0,76838.47,76838.47,76838.47,232856365.58999977,232856365.58999977,ACH,AUD
2025-03-20,Settlement from ClientLine,Processor Payout Batch,SET-20250318-ClientLine-Visa-USD,,0,0,0,183354.41,183354.41,183354.41,233039719.99999976,233039719.99999976,ACH,USD
2025-03-20,Settlement from ClientLine,Processor Payout Batch,SET-20250318-ClientLine-Visa-GBP,,0,0,0,36636.27,36636.27,36636.27,233076356.26999977,233076356.26999977,ACH,GBP
2025-03-20,Settlement from ClientLine,Processor Payout Batch,SET-20250318-ClientLine-Visa-EUR,,0,0,0,53759.35,53759.35,53759.35,233130115.61999977,233130115.61999977,ACH,EUR
2025-03-20,Settlement from ClientLine,Processor Payout Batch,SET-20250318-ClientLine-Visa-CAD,,0,0,0,28279.49,28279.49,28279.49,233158395.10999978,233158395.10999978,ACH,CAD
2025-03-20,Settlement from ClientLine,Processor Payout Batch,SET-20250318-ClientLine-Visa-AUD,,0,0,0,23774.66,23774.66,23774.66,233182169.76999977,233182169.76999977,ACH,AUD
2025-03-20,Settlement from ClientLine,Processor Payout Batch,SET-20250318-ClientLine-Mastercard-USD,,0,0,0,196709.23,196709.23,196709.23,233378878.99999976,233378878.99999976,ACH,USD
2025-03-20,Settlement from ClientLine,Processor Payout Batch,SET-20250318-ClientLine-Mastercard-GBP,,0,0,0,34593.82,34593.82,34593.82,233413472.81999975,233413472.81999975,ACH,GBP
2025-03-20,Settlement from ClientLine,Processor Payout Batch,SET-20250318-ClientLine-Mastercard-EUR,,0,0,0,43166.88,43166.88,43166.88,233456639.69999975,233456639.69999975,ACH,EUR
2025-03-20,Settlement from PayPal,Processor Payout Batch,SET-20250318-PayPal-N/A-USD,,0,0,0,708968.47,708968.47,708968.47,234165608.16999975,234165608.16999975,ACH,USD
2025-03-20,Settlement from ClientLine,Processor Payout Batch,SET-20250318-ClientLine-Mastercard-AUD,,0,0,0,23883.34,23883.34,23883.34,234189491.50999975,234189491.50999975,ACH,AUD
2025-03-20,Settlement from Amex,Processor Payout Batch,SET-20250318-Amex-Amex-USD,,0,0,0,184194.21,184194.21,184194.21,234373685.71999976,234373685.71999976,ACH,USD
2025-03-20,Settlement from Amex,Processor Payout Batch,SET-20250318-Amex-Amex-GBP,,0,0,0,30315.19,30315.19,30315.19,234404000.90999976,234404000.90999976,ACH,GBP
2025-03-20,Settlement from Amex,Processor Payout Batch,SET-20250318-Amex-Amex-EUR,,0,0,0,67928.91,67928.91,67928.91,234471929.81999975,234471929.81999975,ACH,EUR
2025-03-20,Settlement from Amex,Processor Payout Batch,SET-20250318-Amex-Amex-AUD,,0,0,0,19613.09,19613.09,19613.09,234491542.90999976,234491542.90999976,ACH,AUD
2025-03-20,Settlement from PayPal,Processor Payout Batch,SET-20250318-PayPal-N/A-GBP,,0,0,0,102476.62,102476.62,102476.62,234594019.52999976,234594019.52999976,ACH,GBP
2025-03-20,Settlement from ClientLine,Processor Payout Batch,SET-20250318-ClientLine-Mastercard-CAD,,0,0,0,30274.18,30274.18,30274.18,234624293.70999977,234624293.70999977,ACH,CAD
2025-03-20,Settlement from PayPal,Processor Payout Batch,SET-20250316-PayPal-N/A-GBP,,0,0,0,73736.23,73736.23,73736.23,234698029.93999976,234698029.93999976,ACH,GBP
2025-03-20,Settlement from PayPal,Processor Payout Batch,SET-20250316-PayPal-N/A-USD,,0,0,0,681556.78,681556.78,681556.78,235379586.71999976,235379586.71999976,ACH,USD
2025-03-20,Settlement from Amex,Processor Payout Batch,SET-20250316-Amex-Amex-AUD,,0,0,0,29391.22,29391.22,29391.22,235408977.93999976,235408977.93999976,ACH,AUD
2025-03-20,Settlement from Amex,Processor Payout Batch,SET-20250316-Amex-Amex-CAD,,0,0,0,32406.22,32406.22,32406.22,235441384.15999976,235441384.15999976,ACH,CAD
2025-03-20,Settlement from Amex,Processor Payout Batch,SET-20250316-Amex-Amex-EUR,,0,0,0,39601.65,39601.65,39601.65,235480985.80999976,235480985.80999976,ACH,EUR
2025-03-20,Settlement from Amex,Processor Payout Batch,SET-20250316-Amex-Amex-GBP,,0,0,0,32374.09,32374.09,32374.09,235513359.89999977,235513359.89999977,ACH,GBP
2025-03-20,Settlement from Amex,Processor Payout Batch,SET-20250316-Amex-Amex-USD,,0,0,0,212683.61,212683.61,212683.61,235726043.50999978,235726043.50999978,ACH,USD
2025-03-20,Settlement from ClientLine,Processor Payout Batch,SET-20250316-ClientLine-Mastercard-CAD,,0,0,0,29225.22,29225.22,29225.22,235755268.72999978,235755268.72999978,ACH,CAD
2025-03-20,Settlement from ClientLine,Processor Payout Batch,SET-20250316-ClientLine-Mastercard-EUR,,0,0,0,56461.04,56461.04,56461.04,235811729.76999977,235811729.76999977,ACH,EUR
2025-03-20,Settlement from ClientLine,Processor Payout Batch,SET-20250316-ClientLine-Mastercard-GBP,,0,0,0,17408.22,17408.22,17408.22,235829137.98999977,235829137.98999977,ACH,GBP
2025-03-20,Settlement from ClientLine,Processor Payout Batch,SET-20250316-ClientLine-Mastercard-USD,,0,0,0,189634.09,189634.09,189634.09,236018772.07999977,236018772.07999977,ACH,USD
2025-03-20,Settlement from ClientLine,Processor Payout Batch,SET-20250316-ClientLine-Visa-AUD,,0,0,0,22367.84,22367.84,22367.84,236041139.91999978,236041139.91999978,ACH,AUD
2025-03-20,Settlement from ClientLine,Processor Payout Batch,SET-20250316-ClientLine-Mastercard-AUD,,0,0,0,37487.7,37487.7,37487.7,236078627.61999977,236078627.61999977,ACH,AUD
2025-03-20,Settlement from ClientLine,Processor Payout Batch,SET-20250316-ClientLine-Visa-EUR,,0,0,0,53199.63,53199.63,53199.63,236131827.24999976,236131827.24999976,ACH,EUR
2025-03-20,Settlement from ClientLine,Processor Payout Batch,SET-20250316-ClientLine-Visa-CAD,,0,0,0,17731.94,17731.94,17731.94,236149559.18999976,236149559.18999976,ACH,CAD
2025-03-20,Settlement from PayPal,Processor Payout Batch,SET-20250316-PayPal-N/A-CAD,,0,0,0,73150.76,73150.76,73150.76,236222709.94999975,236222709.94999975,ACH,CAD
2025-03-20,Settlement from PayPal,Processor Payout Batch,SET-20250316-PayPal-N/A-AUD,,0,0,0,42572.53,42572.53,42572.53,236265282.47999975,236265282.47999975,ACH,AUD
2025-03-20,Settlement from GoCardless,Processor Payout Batch,SET-20250316-GoCardless-N/A-USD,,0,0,0,650149.16,650149.16,650149.16,236915431.63999975,236915431.63999975,ACH,USD
2025-03-20,Settlement from GoCardless,Processor Payout Batch,SET-20250316-GoCardless-N/A-GBP,,0,0,0,80583.58,80583.58,80583.58,236996015.21999976,236996015.21999976,ACH,GBP
2025-03-20,Settlement from PayPal,Processor Payout Batch,SET-20250316-PayPal-N/A-EUR,,0,0,0,171202.58,171202.58,171202.58,237167217.79999977,237167217.79999977,ACH,EUR
2025-03-20,Settlement from GoCardless,Processor Payout Batch,SET-20250316-GoCardless-N/A-CAD,,0,0,0,73775.85,73775.85,73775.85,237240993.64999977,237240993.64999977,ACH,CAD
2025-03-20,Settlement from GoCardless,Processor Payout Batch,SET-20250316-GoCardless-N/A-AUD,,0,0,0,95144.79,95144.79,95144.79,237336138.43999976,237336138.43999976,ACH,AUD
2025-03-20,Settlement from ClientLine,Processor Payout Batch,SET-20250316-ClientLine-Visa-USD,,0,0,0,205656.26,205656.26,205656.26,237541794.69999975,237541794.69999975,ACH,USD
2025-03-20,Settlement from ClientLine,Processor Payout Batch,SET-20250316-ClientLine-Visa-GBP,,0,0,0,36373.77,36373.77,36373.77,237578168.46999976,237578168.46999976,ACH,GBP
2025-03-20,Settlement from GoCardless,Processor Payout Batch,SET-20250316-GoCardless-N/A-EUR,,0,0,0,160477.09,160477.09,160477.09,237738645.55999976,237738645.55999976,ACH,EUR
2025-03-21,Settlement from ClientLine,Processor Payout Batch,SET-20250319-ClientLine-Visa-GBP,,0,0,0,43902.63,43902.63,43902.63,237782548.18999976,237782548.18999976,ACH,GBP
2025-03-21,Settlement from ClientLine,Processor Payout Batch,SET-20250319-ClientLine-Visa-USD,,0,0,0,207267.51,207267.51,207267.51,237989815.69999975,237989815.69999975,ACH,USD
2025-03-21,Settlement from GoCardless,Processor Payout Batch,SET-20250319-GoCardless-N/A-AUD,,0,0,0,81017.57,81017.57,81017.57,238070833.26999974,238070833.26999974,ACH,AUD
2025-03-21,Settlement from GoCardless,Processor Payout Batch,SET-20250319-GoCardless-N/A-CAD,,0,0,0,80678.57,80678.57,80678.57,238151511.83999974,238151511.83999974,ACH,CAD
2025-03-21,Settlement from GoCardless,Processor Payout Batch,SET-20250319-GoCardless-N/A-EUR,,0,0,0,177354.18,177354.18,177354.18,238328866.01999974,238328866.01999974,ACH,EUR
2025-03-21,Settlement from PayPal,Processor Payout Batch,SET-20250319-PayPal-N/A-CAD,,0,0,0,64004.0,64004.0,64004.0,238392870.01999974,238392870.01999974,ACH,CAD
2025-03-21,Settlement from PayPal,Processor Payout Batch,SET-20250319-PayPal-N/A-AUD,,0,0,0,85282.41,85282.41,85282.41,238478152.42999974,238478152.42999974,ACH,AUD
2025-03-21,Settlement from PayPal,Processor Payout Batch,SET-20250319-PayPal-N/A-EUR,,0,0,0,186329.98,186329.98,186329.98,238664482.40999973,238664482.40999973,ACH,EUR
2025-03-21,Settlement from PayPal,Processor Payout Batch,SET-20250319-PayPal-N/A-GBP,,0,0,0,112719.8,112719.8,112719.8,238777202.20999974,238777202.20999974,ACH,GBP
2025-03-21,Settlement from PayPal,Processor Payout Batch,SET-20250319-PayPal-N/A-USD,,0,0,0,586898.94,586898.94,586898.94,239364101.14999974,239364101.14999974,ACH,USD
2025-03-21,Settlement from GoCardless,Processor Payout Batch,SET-20250319-GoCardless-N/A-USD,,0,0,0,614267.84,614267.84,614267.84,239978368.98999974,239978368.98999974,ACH,USD
2025-03-21,Settlement from ClientLine,Processor Payout Batch,SET-20250319-ClientLine-Visa-EUR,,0,0,0,58691.31,58691.31,58691.31,240037060.29999974,240037060.29999974,ACH,EUR
2025-03-21,Settlement from GoCardless,Processor Payout Batch,SET-20250319-GoCardless-N/A-GBP,,0,0,0,125860.09,125860.09,125860.09,240162920.38999975,240162920.38999975,ACH,GBP
2025-03-21,Settlement from ClientLine,Processor Payout Batch,SET-20250319-ClientLine-Visa-AUD,,0,0,0,20229.62,20229.62,20229.62,240183150.00999975,240183150.00999975,ACH,AUD
2025-03-21,Settlement from Amex,Processor Payout Batch,SET-20250319-Amex-Amex-CAD,,0,0,0,5239.3,5239.3,5239.3,240188389.30999976,240188389.30999976,ACH,CAD
2025-03-21,Settlement from Amex,Processor Payout Batch,SET-20250319-Amex-Amex-EUR,,0,0,0,57877.98,57877.98,57877.98,240246267.28999975,240246267.28999975,ACH,EUR
2025-03-21,Settlement from Amex,Processor Payout Batch,SET-20250319-Amex-Amex-GBP,,0,0,0,39569.5,39569.5,39569.5,240285836.78999975,240285836.78999975,ACH,GBP
2025-03-21,Settlement from Amex,Processor Payout Batch,SET-20250319-Amex-Amex-USD,,0,0,0,176554.77,176554.77,176554.77,240462391.55999976,240462391.55999976,ACH,USD
2025-03-21,Settlement from ClientLine,Processor Payout Batch,SET-20250319-ClientLine-Mastercard-AUD,,0,0,0,19570.91,19570.91,19570.91,240481962.46999976,240481962.46999976,ACH,AUD
2025-03-21,Settlement from Amex,Processor Payout Batch,SET-20250319-Amex-Amex-AUD,,0,0,0,31473.28,31473.28,31473.28,240513435.74999976,240513435.74999976,ACH,AUD
2025-03-21,Settlement from ClientLine,Processor Payout Batch,SET-20250319-ClientLine-Mastercard-CAD,,0,0,0,15391.83,15391.83,15391.83,240528827.57999977,240528827.57999977,ACH,CAD
2025-03-21,Settlement from ClientLine,Processor Payout Batch,SET-20250319-ClientLine-Mastercard-USD,,0,0,0,236709.75,236709.75,236709.75,240765537.32999977,240765537.32999977,ACH,USD
2025-03-21,Settlement from ClientLine,Processor Payout Batch,SET-20250319-ClientLine-Visa-CAD,,0,0,0,17207.15,17207.15,17207.15,240782744.47999978,240782744.47999978,ACH,CAD
2025-03-21,Settlement from ClientLine,Processor Payout Batch,SET-20250319-ClientLine-Mastercard-EUR,,0,0,0,80226.02,80226.02,80226.02,240862970.4999998,240862970.4999998,ACH,EUR
2025-03-21,Settlement from ClientLine,Processor Payout Batch,SET-20250319-ClientLine-Mastercard-GBP,,0,0,0,33534.36,33534.36,33534.36,240896504.8599998,240896504.8599998,ACH,GBP
2025-03-24,Settlement from ClientLine,Processor Payout Batch,SET-20250320-ClientLine-Visa-GBP,,0,0,0,35079.7,35079.7,35079.7,240931584.5599998,240931584.5599998,ACH,GBP
2025-03-24,Settlement from PayPal,Processor Payout Batch,SET-20250320-PayPal-N/A-GBP,,0,0,0,88704.85,88704.85,88704.85,241020289.4099998,241020289.4099998,ACH,GBP
2025-03-24,Settlement from PayPal,Processor Payout Batch,SET-20250320-PayPal-N/A-EUR,,0,0,0,154408.72,154408.72,154408.72,241174698.1299998,241174698.1299998,ACH,EUR
2025-03-24,Settlement from PayPal,Processor Payout Batch,SET-20250320-PayPal-N/A-CAD,,0,0,0,79176.37,79176.37,79176.37,241253874.4999998,241253874.4999998,ACH,CAD
2025-03-24,Settlement from PayPal,Processor Payout Batch,SET-20250320-PayPal-N/A-USD,,0,0,0,663639.73,663639.73,663639.73,241917514.22999978,241917514.22999978,ACH,USD
2025-03-24,Settlement from GoCardless,Processor Payout Batch,SET-20250320-GoCardless-N/A-USD,,0,0,0,641470.29,641470.29,641470.29,242558984.51999977,242558984.51999977,ACH,USD
2025-03-24,Settlement from GoCardless,Processor Payout Batch,SET-20250320-GoCardless-N/A-GBP,,0,0,0,90154.94,90154.94,90154.94,242649139.45999977,242649139.45999977,ACH,GBP
2025-03-24,Settlement from GoCardless,Processor Payout Batch,SET-20250320-GoCardless-N/A-EUR,,0,0,0,153890.69,153890.69,153890.69,242803030.14999977,242803030.14999977,ACH,EUR
2025-03-24,Settlement from GoCardless,Processor Payout Batch,SET-20250320-GoCardless-N/A-CAD,,0,0,0,79626.11,79626.11,79626.11,242882656.25999978,242882656.25999978,ACH,CAD
2025-03-24,Settlement from GoCardless,Processor Payout Batch,SET-20250320-GoCardless-N/A-AUD,,0,0,0,87417.97,87417.97,87417.97,242970074.22999978,242970074.22999978,ACH,AUD
2025-03-24,Settlement from ClientLine,Processor Payout Batch,SET-20250320-ClientLine-Visa-USD,,0,0,0,202384.66,202384.66,202384.66,243172458.88999978,243172458.88999978,ACH,USD
2025-03-24,Settlement from PayPal,Processor Payout Batch,SET-20250320-PayPal-N/A-AUD,,0,0,0,50332.76,50332.76,50332.76,243222791.64999977,243222791.64999977,ACH,AUD
2025-03-24,Settlement from ClientLine,Processor Payout Batch,SET-20250320-ClientLine-Visa-EUR,,0,0,0,31249.1,31249.1,31249.1,243254040.74999976,243254040.74999976,ACH,EUR
2025-03-24,Settlement from ClientLine,Processor Payout Batch,SET-20250320-ClientLine-Visa-AUD,,0,0,0,27463.37,27463.37,27463.37,243281504.11999977,243281504.11999977,ACH,AUD
2025-03-24,Settlement from ClientLine,Processor Payout Batch,SET-20250320-ClientLine-Visa-CAD,,0,0,0,50437.37,50437.37,50437.37,243331941.48999977,243331941.48999977,ACH,CAD
2025-03-24,Settlement from Amex,Processor Payout Batch,SET-20250320-Amex-Amex-AUD,,0,0,0,20538.98,20538.98,20538.98,243352480.46999976,243352480.46999976,ACH,AUD
2025-03-24,Settlement from Amex,Processor Payout Batch,SET-20250320-Amex-Amex-CAD,,0,0,0,5700.37,5700.37,5700.37,243358180.83999977,243358180.83999977,ACH,CAD
2025-03-24,Settlement from Amex,Processor Payout Batch,SET-20250320-Amex-Amex-GBP,,0,0,0,24518.45,24518.45,24518.45,243382699.28999975,243382699.28999975,ACH,GBP
2025-03-24,Settlement from Amex,Processor Payout Batch,SET-20250320-Amex-Amex-USD,,0,0,0,215009.74,215009.74,215009.74,243597709.02999976,243597709.02999976,ACH,USD
2025-03-24,Settlement from Amex,Processor Payout Batch,SET-20250320-Amex-Amex-EUR,,0,0,0,39144.78,39144.78,39144.78,243636853.80999976,243636853.80999976,ACH,EUR
2025-03-24,Settlement from ClientLine,Processor Payout Batch,SET-20250320-ClientLine-Mastercard-CAD,,0,0,0,17155.43,17155.43,17155.43,243654009.23999977,243654009.23999977,ACH,CAD
2025-03-24,Settlement from ClientLine,Processor Payout Batch,SET-20250320-ClientLine-Mastercard-EUR,,0,0,0,48535.77,48535.77,48535.77,243702545.00999978,243702545.00999978,ACH,EUR
2025-03-24,Settlement from ClientLine,Processor Payout Batch,SET-20250320-ClientLine-Mastercard-GBP,,0,0,0,25794.91,25794.91,25794.91,243728339.91999978,243728339.91999978,ACH,GBP
2025-03-24,Settlement from ClientLine,Processor Payout Batch,SET-20250320-ClientLine-Mastercard-USD,,0,0,0,199918.48,199918.48,199918.48,243928258.39999977,243928258.39999977,ACH,USD
2025-03-24,Settlement from ClientLine,Processor Payout Batch,SET-20250320-ClientLine-Mastercard-AUD,,0,0,0,11048.09,11048.09,11048.09,243939306.48999977,243939306.48999977,ACH,AUD
2025-03-25,Settlement from GoCardless,Processor Payout Batch,SET-20250321-GoCardless-N/A-GBP,,0,0,0,88348.14,88348.14,88348.14,244027654.62999976,244027654.62999976,ACH,GBP
2025-03-25,Settlement from GoCardless,Processor Payout Batch,SET-20250321-GoCardless-N/A-AUD,,0,0,0,94798.95,94798.95,94798.95,244122453.57999974,244122453.57999974,ACH,AUD
2025-03-25,Settlement from GoCardless,Processor Payout Batch,SET-20250321-GoCardless-N/A-CAD,,0,0,0,78243.34,78243.34,78243.34,244200696.91999975,244200696.91999975,ACH,CAD
2025-03-25,Settlement from GoCardless,Processor Payout Batch,SET-20250321-GoCardless-N/A-EUR,,0,0,0,126582.49,126582.49,126582.49,244327279.40999976,244327279.40999976,ACH,EUR
2025-03-25,Settlement from GoCardless,Processor Payout Batch,SET-20250321-GoCardless-N/A-USD,,0,0,0,619821.92,619821.92,619821.92,244947101.32999974,244947101.32999974,ACH,USD
2025-03-25,Settlement from ClientLine,Processor Payout Batch,SET-20250321-ClientLine-Visa-USD,,0,0,0,204319.82,204319.82,204319.82,245151421.14999974,245151421.14999974,ACH,USD
2025-03-25,Settlement from PayPal,Processor Payout Batch,SET-20250321-PayPal-N/A-CAD,,0,0,0,67784.72,67784.72,67784.72,245219205.86999974,245219205.86999974,ACH,CAD
2025-03-25,Settlement from PayPal,Processor Payout Batch,SET-20250321-PayPal-N/A-EUR,,0,0,0,116608.01,116608.01,116608.01,245335813.87999973,245335813.87999973,ACH,EUR
2025-03-25,Settlement from PayPal,Processor Payout Batch,SET-20250321-PayPal-N/A-GBP,,0,0,0,65649.03,65649.03,65649.03,245401462.90999973,245401462.90999973,ACH,GBP
2025-03-25,Settlement from PayPal,Processor Payout Batch,SET-20250321-PayPal-N/A-USD,,0,0,0,549706.53,549706.53,549706.53,245951169.43999973,245951169.43999973,ACH,USD
2025-03-25,Settlement from PayPal,Processor Payout Batch,SET-20250321-PayPal-N/A-AUD,,0,0,0,79579.64,79579.64,79579.64,246030749.07999972,246030749.07999972,ACH,AUD
2025-03-25,Settlement from ClientLine,Processor Payout Batch,SET-20250321-ClientLine-Visa-GBP,,0,0,0,47383.86,47383.86,47383.86,246078132.93999973,246078132.93999973,ACH,GBP
2025-03-25,Settlement from ClientLine,Processor Payout Batch,SET-20250321-ClientLine-Visa-EUR,,0,0,0,58306.83,58306.83,58306.83,246136439.76999974,246136439.76999974,ACH,EUR
2025-03-25,Settlement from ClientLine,Processor Payout Batch,SET-20250321-ClientLine-Visa-CAD,,0,0,0,21892.65,21892.65,21892.65,246158332.41999975,246158332.41999975,ACH,CAD
2025-03-25,Settlement from Amex,Processor Payout Batch,SET-20250321-Amex-Amex-CAD,,0,0,0,12574.48,12574.48,12574.48,246170906.89999974,246170906.89999974,ACH,CAD
2025-03-25,Settlement from Amex,Processor Payout Batch,SET-20250321-Amex-Amex-EUR,,0,0,0,70408.7,70408.7,70408.7,246241315.59999973,246241315.59999973,ACH,EUR
2025-03-25,Settlement from Amex,Processor Payout Batch,SET-20250321-Amex-Amex-GBP,,0,0,0,19172.17,19172.17,19172.17,246260487.7699997,246260487.7699997,ACH,GBP
2025-03-25,Settlement from Amex,Processor Payout Batch,SET-20250321-Amex-Amex-USD,,0,0,0,178603.82,178603.82,178603.82,246439091.5899997,246439091.5899997,ACH,USD
2025-03-25,Settlement from ClientLine,Processor Payout Batch,SET-20250321-ClientLine-Mastercard-AUD,,0,0,0,28548.21,28548.21,28548.21,246467639.7999997,246467639.7999997,ACH,AUD
2025-03-25,Settlement from Amex,Processor Payout Batch,SET-20250321-Amex-Amex-AUD,,0,0,0,30730.86,30730.86,30730.86,246498370.65999973,246498370.65999973,ACH,AUD
2025-03-25,Settlement from ClientLine,Processor Payout Batch,SET-20250321-ClientLine-Mastercard-EUR,,0,0,0,55761.55,55761.55,55761.55,246554132.20999974,246554132.20999974,ACH,EUR
2025-03-25,Settlement from ClientLine,Processor Payout Batch,SET-20250321-ClientLine-Mastercard-GBP,,0,0,0,33294.09,33294.09,33294.09,246587426.29999974,246587426.29999974,ACH,GBP
2025-03-25,Settlement from ClientLine,Processor Payout Batch,SET-20250321-ClientLine-Mastercard-USD,,0,0,0,204122.4,204122.4,204122.4,246791548.69999975,246791548.69999975,ACH,USD
2025-03-25,Settlement from ClientLine,Processor Payout Batch,SET-20250321-ClientLine-Visa-AUD,,0,0,0,25230.6,25230.6,25230.6,246816779.29999974,246816779.29999974,ACH,AUD
2025-03-25,Settlement from ClientLine,Processor Payout Batch,SET-20250321-ClientLine-Mastercard-CAD,,0,0,0,20849.89,20849.89,20849.89,246837629.18999973,246837629.18999973,ACH,CAD
2025-03-26,Settlement from ClientLine,Processor Payout Batch,SET-20250324-ClientLine-Visa-AUD,,0,0,0,16375.6,16375.6,16375.6,246854004.78999972,246854004.78999972,ACH,AUD
2025-03-26,Settlement from Amex,Processor Payout Batch,SET-20250324-Amex-Amex-CAD,,0,0,0,22590.59,22590.59,22590.59,246876595.37999973,246876595.37999973,ACH,CAD
2025-03-26,Settlement from Amex,Processor Payout Batch,SET-20250324-Amex-Amex-EUR,,0,0,0,56632.25,56632.25,56632.25,246933227.62999973,246933227.62999973,ACH,EUR
2025-03-26,Settlement from Amex,Processor Payout Batch,SET-20250324-Amex-Amex-GBP,,0,0,0,19983.8,19983.8,19983.8,246953211.42999974,246953211.42999974,ACH,GBP
2025-03-26,Settlement from Amex,Processor Payout Batch,SET-20250324-Amex-Amex-USD,,0,0,0,261058.79,261058.79,261058.79,247214270.21999973,247214270.21999973,ACH,USD
2025-03-26,Settlement from ClientLine,Processor Payout Batch,SET-20250324-ClientLine-Mastercard-AUD,,0,0,0,15478.16,15478.16,15478.16,247229748.37999973,247229748.37999973,ACH,AUD
2025-03-26,Settlement from ClientLine,Processor Payout Batch,SET-20250324-ClientLine-Mastercard-CAD,,0,0,0,10774.55,10774.55,10774.55,247240522.92999974,247240522.92999974,ACH,CAD
2025-03-26,Settlement from ClientLine,Processor Payout Batch,SET-20250324-ClientLine-Mastercard-EUR,,0,0,0,51289.2,51289.2,51289.2,247291812.12999973,247291812.12999973,ACH,EUR
2025-03-26,Settlement from ClientLine,Processor Payout Batch,SET-20250324-ClientLine-Mastercard-GBP,,0,0,0,44365.43,44365.43,44365.43,247336177.55999973,247336177.55999973,ACH,GBP
2025-03-26,Settlement from ClientLine,Processor Payout Batch,SET-20250324-ClientLine-Mastercard-USD,,0,0,0,221325.34,221325.34,221325.34,247557502.89999974,247557502.89999974,ACH,USD
2025-03-26,Settlement from ClientLine,Processor Payout Batch,SET-20250324-ClientLine-Visa-CAD,,0,0,0,21154.56,21154.56,21154.56,247578657.45999974,247578657.45999974,ACH,CAD
2025-03-26,Settlement from GoCardless,Processor Payout Batch,SET-20250324-GoCardless-N/A-EUR,,0,0,0,147763.32,147763.32,147763.32,247726420.77999973,247726420.77999973,ACH,EUR
2025-03-26,Settlement from ClientLine,Processor Payout Batch,SET-20250324-ClientLine-Visa-GBP,,0,0,0,23373.52,23373.52,23373.52,247749794.29999974,247749794.29999974,ACH,GBP
2025-03-26,Settlement from ClientLine,Processor Payout Batch,SET-20250324-ClientLine-Visa-USD,,0,0,0,188239.4,188239.4,188239.4,247938033.69999975,247938033.69999975,ACH,USD
2025-03-26,Settlement from GoCardless,Processor Payout Batch,SET-20250324-GoCardless-N/A-AUD,,0,0,0,91614.78,91614.78,91614.78,248029648.47999975,248029648.47999975,ACH,AUD
2025-03-26,Settlement from GoCardless,Processor Payout Batch,SET-20250324-GoCardless-N/A-CAD,,0,0,0,70764.22,70764.22,70764.22,248100412.69999975,248100412.69999975,ACH,CAD
2025-03-26,Settlement from Amex,Processor Payout Batch,SET-20250324-Amex-Amex-AUD,,0,0,0,27802.64,27802.64,27802.64,248128215.33999974,248128215.33999974,ACH,AUD
2025-03-26,Settlement from GoCardless,Processor Payout Batch,SET-20250324-GoCardless-N/A-GBP,,0,0,0,105101.05,105101.05,105101.05,248233316.38999975,248233316.38999975,ACH,GBP
2025-03-26,Settlement from GoCardless,Processor Payout Batch,SET-20250324-GoCardless-N/A-USD,,0,0,0,595853.03,595853.03,595853.03,248829169.41999975,248829169.41999975,ACH,USD
2025-03-26,Settlement from PayPal,Processor Payout Batch,SET-20250324-PayPal-N/A-AUD,,0,0,0,81149.65,81149.65,81149.65,248910319.06999975,248910319.06999975,ACH,AUD
2025-03-26,Settlement from PayPal,Processor Payout Batch,SET-20250324-PayPal-N/A-CAD,,0,0,0,82858.21,82858.21,82858.21,248993177.27999976,248993177.27999976,ACH,CAD
2025-03-26,Settlement from PayPal,Processor Payout Batch,SET-20250324-PayPal-N/A-EUR,,0,0,0,176562.97,176562.97,176562.97,249169740.24999976,249169740.24999976,ACH,EUR
2025-03-26,Settlement from ClientLine,Processor Payout Batch,SET-20250324-ClientLine-Visa-EUR,,0,0,0,33692.34,33692.34,33692.34,249203432.58999977,249203432.58999977,ACH,EUR
2025-03-26,Settlement from PayPal,Processor Payout Batch,SET-20250324-PayPal-N/A-GBP,,0,0,0,122153.61,122153.61,122153.61,249325586.19999978,249325586.19999978,ACH,GBP
2025-03-26,Settlement from PayPal,Processor Payout Batch,SET-20250324-PayPal-N/A-USD,,0,0,0,606503.07,606503.07,606503.07,249932089.26999977,249932089.26999977,ACH,USD
2025-03-26,Settlement from ClientLine,Processor Payout Batch,SET-20250322-ClientLine-Visa-AUD,,0,0,0,25219.84,25219.84,25219.84,249957309.10999978,249957309.10999978,ACH,AUD
2025-03-26,Settlement from PayPal,Processor Payout Batch,SET-20250322-PayPal-N/A-CAD,,0,0,0,60878.24,60878.24,60878.24,250018187.3499998,250018187.3499998,ACH,CAD
2025-03-26,Settlement from PayPal,Processor Payout Batch,SET-20250322-PayPal-N/A-AUD,,0,0,0,58146.12,58146.12,58146.12,250076333.4699998,250076333.4699998,ACH,AUD
2025-03-26,Settlement from GoCardless,Processor Payout Batch,SET-20250322-GoCardless-N/A-USD,,0,0,0,556067.92,556067.92,556067.92,250632401.38999978,250632401.38999978,ACH,USD
2025-03-26,Settlement from GoCardless,Processor Payout Batch,SET-20250322-GoCardless-N/A-GBP,,0,0,0,127443.81,127443.81,127443.81,250759845.19999978,250759845.19999978,ACH,GBP
2025-03-26,Settlement from GoCardless,Processor Payout Batch,SET-20250322-GoCardless-N/A-EUR,,0,0,0,126808.27,126808.27,126808.27,250886653.4699998,250886653.4699998,ACH,EUR
2025-03-26,Settlement from GoCardless,Processor Payout Batch,SET-20250322-GoCardless-N/A-CAD,,0,0,0,50843.35,50843.35,50843.35,250937496.81999978,250937496.81999978,ACH,CAD
2025-03-26,Settlement from GoCardless,Processor Payout Batch,SET-20250322-GoCardless-N/A-AUD,,0,0,0,62144.19,62144.19,62144.19,250999641.00999978,250999641.00999978,ACH,AUD
2025-03-26,Settlement from ClientLine,Processor Payout Batch,SET-20250322-ClientLine-Visa-USD,,0,0,0,217008.6,217008.6,217008.6,251216649.60999978,251216649.60999978,ACH,USD
2025-03-26,Settlement from ClientLine,Processor Payout Batch,SET-20250322-ClientLine-Visa-GBP,,0,0,0,53671.64,53671.64,53671.64,251270321.24999976,251270321.24999976,ACH,GBP
2025-03-26,Settlement from ClientLine,Processor Payout Batch,SET-20250322-ClientLine-Visa-EUR,,0,0,0,63671.51,63671.51,63671.51,251333992.75999975,251333992.75999975,ACH,EUR
2025-03-26,Settlement from ClientLine,Processor Payout Batch,SET-20250322-ClientLine-Visa-CAD,,0,0,0,27565.96,27565.96,27565.96,251361558.71999976,251361558.71999976,ACH,CAD
2025-03-26,Settlement from PayPal,Processor Payout Batch,SET-20250322-PayPal-N/A-EUR,,0,0,0,178800.48,178800.48,178800.48,251540359.19999975,251540359.19999975,ACH,EUR
2025-03-26,Settlement from ClientLine,Processor Payout Batch,SET-20250322-ClientLine-Mastercard-USD,,0,0,0,194503.98,194503.98,194503.98,251734863.17999974,251734863.17999974,ACH,USD
2025-03-26,Settlement from ClientLine,Processor Payout Batch,SET-20250322-ClientLine-Mastercard-GBP,,0,0,0,15516.93,15516.93,15516.93,251750380.10999975,251750380.10999975,ACH,GBP
2025-03-26,Settlement from ClientLine,Processor Payout Batch,SET-20250322-ClientLine-Mastercard-EUR,,0,0,0,43114.32,43114.32,43114.32,251793494.42999974,251793494.42999974,ACH,EUR
2025-03-26,Settlement from ClientLine,Processor Payout Batch,SET-20250322-ClientLine-Mastercard-CAD,,0,0,0,17494.41,17494.41,17494.41,251810988.83999974,251810988.83999974,ACH,CAD
2025-03-26,Settlement from ClientLine,Processor Payout Batch,SET-20250322-ClientLine-Mastercard-AUD,,0,0,0,23804.08,23804.08,23804.08,251834792.91999975,251834792.91999975,ACH,AUD
2025-03-26,Settlement from PayPal,Processor Payout Batch,SET-20250322-PayPal-N/A-GBP,,0,0,0,91152.1,91152.1,91152.1,251925945.01999974,251925945.01999974,ACH,GBP
2025-03-26,Settlement from Amex,Processor Payout Batch,SET-20250322-Amex-Amex-USD,,0,0,0,125492.23,125492.23,125492.23,252051437.24999973,252051437.24999973,ACH,USD
2025-03-26,Settlement from Amex,Processor Payout Batch,SET-20250322-Amex-Amex-GBP,,0,0,0,47375.72,47375.72,47375.72,252098812.96999973,252098812.96999973,ACH,GBP
2025-03-26,Settlement from Amex,Processor Payout Batch,SET-20250322-Amex-Amex-EUR,,0,0,0,33175.03,33175.03,33175.03,252131987.99999973,252131987.99999973,ACH,EUR
2025-03-26,Settlement from Amex,Processor Payout Batch,SET-20250322-Amex-Amex-CAD,,0,0,0,25436.33,25436.33,25436.33,252157424.32999974,252157424.32999974,ACH,CAD
2025-03-26,Settlement from Amex,Processor Payout Batch,SET-20250322-Amex-Amex-AUD,,0,0,0,19385.89,19385.89,19385.89,252176810.21999973,252176810.21999973,ACH,AUD
2025-03-26,Settlement from PayPal,Processor Payout Batch,SET-20250322-PayPal-N/A-USD,,0,0,0,556830.09,556830.09,556830.09,252733640.30999973,252733640.30999973,ACH,USD
2025-03-27,Settlement from PayPal,Processor Payout Batch,SET-20250325-PayPal-N/A-GBP,,0,0,0,110197.6,110197.6,110197.6,252843837.90999973,252843837.90999973,ACH,GBP
2025-03-27,Settlement from Amex,Processor Payout Batch,SET-20250325-Amex-Amex-AUD,,0,0,0,27674.13,27674.13,27674.13,252871512.03999972,252871512.03999972,ACH,AUD
2025-03-27,Settlement from Amex,Processor Payout Batch,SET-20250325-Amex-Amex-EUR,,0,0,0,69068.44,69068.44,69068.44,252940580.47999972,252940580.47999972,ACH,EUR
2025-03-27,Settlement from PayPal,Processor Payout Batch,SET-20250325-PayPal-N/A-EUR,,0,0,0,122887.87,122887.87,122887.87,253063468.34999973,253063468.34999973,ACH,EUR
2025-03-27,Settlement from PayPal,Processor Payout Batch,SET-20250325-PayPal-N/A-CAD,,0,0,0,62273.77,62273.77,62273.77,253125742.11999974,253125742.11999974,ACH,CAD
2025-03-27,Settlement from PayPal,Processor Payout Batch,SET-20250325-PayPal-N/A-AUD,,0,0,0,96886.39,96886.39,96886.39,253222628.50999972,253222628.50999972,ACH,AUD
2025-03-27,Settlement from GoCardless,Processor Payout Batch,SET-20250325-GoCardless-N/A-USD,,0,0,0,661800.67,661800.67,661800.67,253884429.1799997,253884429.1799997,ACH,USD
2025-03-27,Settlement from GoCardless,Processor Payout Batch,SET-20250325-GoCardless-N/A-GBP,,0,0,0,73883.89,73883.89,73883.89,253958313.0699997,253958313.0699997,ACH,GBP
2025-03-27,Settlement from GoCardless,Processor Payout Batch,SET-20250325-GoCardless-N/A-CAD,,0,0,0,91487.92,91487.92,91487.92,254049800.98999968,254049800.98999968,ACH,CAD
2025-03-27,Settlement from GoCardless,Processor Payout Batch,SET-20250325-GoCardless-N/A-AUD,,0,0,0,92065.37,92065.37,92065.37,254141866.3599997,254141866.3599997,ACH,AUD
2025-03-27,Settlement from ClientLine,Processor Payout Batch,SET-20250325-ClientLine-Visa-USD,,0,0,0,161805.75,161805.75,161805.75,254303672.1099997,254303672.1099997,ACH,USD
2025-03-27,Settlement from ClientLine,Processor Payout Batch,SET-20250325-ClientLine-Visa-GBP,,0,0,0,28387.01,28387.01,28387.01,254332059.11999968,254332059.11999968,ACH,GBP
2025-03-27,Settlement from Amex,Processor Payout Batch,SET-20250325-Amex-Amex-CAD,,0,0,0,21316.99,21316.99,21316.99,254353376.1099997,254353376.1099997,ACH,CAD
2025-03-27,Settlement from ClientLine,Processor Payout Batch,SET-20250325-ClientLine-Visa-EUR,,0,0,0,21725.15,21725.15,21725.15,254375101.2599997,254375101.2599997,ACH,EUR
2025-03-27,Settlement from ClientLine,Processor Payout Batch,SET-20250325-ClientLine-Visa-CAD,,0,0,0,20397.18,20397.18,20397.18,254395498.4399997,254395498.4399997,ACH,CAD
2025-03-27,Settlement from ClientLine,Processor Payout Batch,SET-20250325-ClientLine-Visa-AUD,,0,0,0,14462.13,14462.13,14462.13,254409960.5699997,254409960.5699997,ACH,AUD
2025-03-27,Settlement from ClientLine,Processor Payout Batch,SET-20250325-ClientLine-Mastercard-USD,,0,0,0,198014.42,198014.42,198014.42,254607974.98999968,254607974.98999968,ACH,USD
2025-03-27,Settlement from ClientLine,Processor Payout Batch,SET-20250325-ClientLine-Mastercard-GBP,,0,0,0,37768.22,37768.22,37768.22,254645743.20999968,254645743.20999968,ACH,GBP
2025-03-27,Settlement from ClientLine,Processor Payout Batch,SET-20250325-ClientLine-Mastercard-EUR,,0,0,0,60170.15,60170.15,60170.15,254705913.3599997,254705913.3599997,ACH,EUR
2025-03-27,Settlement from ClientLine,Processor Payout Batch,SET-20250325-ClientLine-Mastercard-CAD,,0,0,0,13508.16,13508.16,13508.16,254719421.51999968,254719421.51999968,ACH,CAD
2025-03-27,Settlement from ClientLine,Processor Payout Batch,SET-20250325-ClientLine-Mastercard-AUD,,0,0,0,39131.94,39131.94,39131.94,254758553.45999968,254758553.45999968,ACH,AUD
2025-03-27,Settlement from Amex,Processor Payout Batch,SET-20250325-Amex-Amex-USD,,0,0,0,164646.95,164646.95,164646.95,254923200.40999967,254923200.40999967,ACH,USD
2025-03-27,Settlement from Amex,Processor Payout Batch,SET-20250325-Amex-Amex-GBP,,0,0,0,32030.29,32030.29,32030.29,254955230.69999966,254955230.69999966,ACH,GBP
2025-03-27,Settlement from PayPal,Processor Payout Batch,SET-20250325-PayPal-N/A-USD,,0,0,0,589118.42,589118.42,589118.42,255544349.11999965,255544349.11999965,ACH,USD
2025-03-27,Settlement from GoCardless,Processor Payout Batch,SET-20250325-GoCardless-N/A-EUR,,0,0,0,131254.27,131254.27,131254.27,255675603.38999966,255675603.38999966,ACH,EUR
2025-03-27,Settlement from ClientLine,Processor Payout Batch,SET-20250323-ClientLine-Visa-EUR,,0,0,0,57949.97,57949.97,57949.97,255733553.35999966,255733553.35999966,ACH,EUR
2025-03-27,Settlement from PayPal,Processor Payout Batch,SET-20250323-PayPal-N/A-GBP,,0,0,0,102139.23,102139.23,102139.23,255835692.58999965,255835692.58999965,ACH,GBP
2025-03-27,Settlement from PayPal,Processor Payout Batch,SET-20250323-PayPal-N/A-USD,,0,0,0,597424.84,597424.84,597424.84,256433117.42999965,256433117.42999965,ACH,USD
2025-03-27,Settlement from Amex,Processor Payout Batch,SET-20250323-Amex-Amex-AUD,,0,0,0,32508.65,32508.65,32508.65,256465626.07999966,256465626.07999966,ACH,AUD
2025-03-27,Settlement from Amex,Processor Payout Batch,SET-20250323-Amex-Amex-CAD,,0,0,0,10691.4,10691.4,10691.4,256476317.47999966,256476317.47999966,ACH,CAD
2025-03-27,Settlement from Amex,Processor Payout Batch,SET-20250323-Amex-Amex-EUR,,0,0,0,41340.75,41340.75,41340.75,256517658.22999966,256517658.22999966,ACH,EUR
2025-03-27,Settlement from Amex,Processor Payout Batch,SET-20250323-Amex-Amex-GBP,,0,0,0,34005.26,34005.26,34005.26,256551663.48999965,256551663.48999965,ACH,GBP
2025-03-27,Settlement from Amex,Processor Payout Batch,SET-20250323-Amex-Amex-USD,,0,0,0,203360.89,203360.89,203360.89,256755024.37999964,256755024.37999964,ACH,USD
2025-03-27,Settlement from ClientLine,Processor Payout Batch,SET-20250323-ClientLine-Mastercard-CAD,,0,0,0,29295.23,29295.23,29295.23,256784319.60999963,256784319.60999963,ACH,CAD
2025-03-27,Settlement from ClientLine,Processor Payout Batch,SET-20250323-ClientLine-Mastercard-EUR,,0,0,0,48009.01,48009.01,48009.01,256832328.61999962,256832328.61999962,ACH,EUR
2025-03-27,Settlement from ClientLine,Processor Payout Batch,SET-20250323-ClientLine-Mastercard-GBP,,0,0,0,37030.18,37030.18,37030.18,256869358.79999962,256869358.79999962,ACH,GBP
2025-03-27,Settlement from ClientLine,Processor Payout Batch,SET-20250323-ClientLine-Mastercard-USD,,0,0,0,174923.21,174923.21,174923.21,257044282.00999963,257044282.00999963,ACH,USD
2025-03-27,Settlement from ClientLine,Processor Payout Batch,SET-20250323-ClientLine-Visa-AUD,,0,0,0,50732.86,50732.86,50732.86,257095014.86999965,257095014.86999965,ACH,AUD
2025-03-27,Settlement from ClientLine,Processor Payout Batch,SET-20250323-ClientLine-Mastercard-AUD,,0,0,0,20237.16,20237.16,20237.16,257115252.02999964,257115252.02999964,ACH,AUD
2025-03-27,Settlement from ClientLine,Processor Payout Batch,SET-20250323-ClientLine-Visa-GBP,,0,0,0,31234.96,31234.96,31234.96,257146486.98999965,257146486.98999965,ACH,GBP
2025-03-27,Settlement from ClientLine,Processor Payout Batch,SET-20250323-ClientLine-Visa-USD,,0,0,0,182339.86,182339.86,182339.86,257328826.84999967,257328826.84999967,ACH,USD
2025-03-27,Settlement from GoCardless,Processor Payout Batch,SET-20250323-GoCardless-N/A-AUD,,0,0,0,105757.3,105757.3,105757.3,257434584.14999968,257434584.14999968,ACH,AUD
2025-03-27,Settlement from GoCardless,Processor Payout Batch,SET-20250323-GoCardless-N/A-CAD,,0,0,0,74931.99,74931.99,74931.99,257509516.1399997,257509516.1399997,ACH,CAD
2025-03-27,Settlement from GoCardless,Processor Payout Batch,SET-20250323-GoCardless-N/A-EUR,,0,0,0,177783.78,177783.78,177783.78,257687299.9199997,257687299.9199997,ACH,EUR
2025-03-27,Settlement from GoCardless,Processor Payout Batch,SET-20250323-GoCardless-N/A-GBP,,0,0,0,69397.75,69397.75,69397.75,257756697.6699997,257756697.6699997,ACH,GBP
2025-03-27,Settlement from GoCardless,Processor Payout Batch,SET-20250323-GoCardless-N/A-USD,,0,0,0,592023.87,592023.87,592023.87,258348721.5399997,258348721.5399997,ACH,USD
2025-03-27,Settlement from PayPal,Processor Payout Batch,SET-20250323-PayPal-N/A-AUD,,0,0,0,52946.16,52946.16,52946.16,258401667.6999997,258401667.6999997,ACH,AUD
2025-03-27,Settlement from PayPal,Processor Payout Batch,SET-20250323-PayPal-N/A-CAD,,0,0,0,66647.72,66647.72,66647.72,258468315.4199997,258468315.4199997,ACH,CAD
2025-03-27,Settlement from PayPal,Processor Payout Batch,SET-20250323-PayPal-N/A-EUR,,0,0,0,168880.38,168880.38,168880.38,258637195.79999968,258637195.79999968,ACH,EUR
2025-03-27,Settlement from ClientLine,Processor Payout Batch,SET-20250323-ClientLine-Visa-CAD,,0,0,0,43935.98,43935.98,43935.98,258681131.77999967,258681131.77999967,ACH,CAD
2025-03-28,Settlement from GoCardless,Processor Payout Batch,SET-20250326-GoCardless-N/A-AUD,,0,0,0,83882.63,83882.63,83882.63,258765014.40999967,258765014.40999967,ACH,AUD
2025-03-28,Settlement from GoCardless,Processor Payout Batch,SET-20250326-GoCardless-N/A-CAD,,0,0,0,71166.21,71166.21,71166.21,258836180.61999968,258836180.61999968,ACH,CAD
2025-03-28,Settlement from GoCardless,Processor Payout Batch,SET-20250326-GoCardless-N/A-EUR,,0,0,0,162246.87,162246.87,162246.87,258998427.48999968,258998427.48999968,ACH,EUR
2025-03-28,Settlement from GoCardless,Processor Payout Batch,SET-20250326-GoCardless-N/A-GBP,,0,0,0,92199.54,92199.54,92199.54,259090627.02999967,259090627.02999967,ACH,GBP
2025-03-28,Settlement from GoCardless,Processor Payout Batch,SET-20250326-GoCardless-N/A-USD,,0,0,0,651326.05,651326.05,651326.05,259741953.0799997,259741953.0799997,ACH,USD
2025-03-28,Settlement from PayPal,Processor Payout Batch,SET-20250326-PayPal-N/A-USD,,0,0,0,636462.68,636462.68,636462.68,260378415.7599997,260378415.7599997,ACH,USD
2025-03-28,Settlement from PayPal,Processor Payout Batch,SET-20250326-PayPal-N/A-CAD,,0,0,0,107282.17,107282.17,107282.17,260485697.92999968,260485697.92999968,ACH,CAD
2025-03-28,Settlement from PayPal,Processor Payout Batch,SET-20250326-PayPal-N/A-EUR,,0,0,0,161976.38,161976.38,161976.38,260647674.30999967,260647674.30999967,ACH,EUR
2025-03-28,Settlement from PayPal,Processor Payout Batch,SET-20250326-PayPal-N/A-GBP,,0,0,0,95347.85,95347.85,95347.85,260743022.15999967,260743022.15999967,ACH,GBP
2025-03-28,Settlement from ClientLine,Processor Payout Batch,SET-20250326-ClientLine-Visa-USD,,0,0,0,209587.04,209587.04,209587.04,260952609.19999966,260952609.19999966,ACH,USD
2025-03-28,Settlement from PayPal,Processor Payout Batch,SET-20250326-PayPal-N/A-AUD,,0,0,0,54433.49,54433.49,54433.49,261007042.68999967,261007042.68999967,ACH,AUD
2025-03-28,Settlement from ClientLine,Processor Payout Batch,SET-20250326-ClientLine-Visa-GBP,,0,0,0,42709.38,42709.38,42709.38,261049752.06999967,261049752.06999967,ACH,GBP
2025-03-28,Settlement from ClientLine,Processor Payout Batch,SET-20250326-ClientLine-Mastercard-CAD,,0,0,0,24106.08,24106.08,24106.08,261073858.14999968,261073858.14999968,ACH,CAD
2025-03-28,Settlement from ClientLine,Processor Payout Batch,SET-20250326-ClientLine-Visa-CAD,,0,0,0,22607.23,22607.23,22607.23,261096465.37999967,261096465.37999967,ACH,CAD
2025-03-28,Settlement from ClientLine,Processor Payout Batch,SET-20250326-ClientLine-Visa-EUR,,0,0,0,42124.09,42124.09,42124.09,261138589.46999967,261138589.46999967,ACH,EUR
2025-03-28,Settlement from Amex,Processor Payout Batch,SET-20250326-Amex-Amex-CAD,,0,0,0,28480.14,28480.14,28480.14,261167069.60999966,261167069.60999966,ACH,CAD
2025-03-28,Settlement from Amex,Processor Payout Batch,SET-20250326-Amex-Amex-EUR,,0,0,0,45112.98,45112.98,45112.98,261212182.58999965,261212182.58999965,ACH,EUR
2025-03-28,Settlement from Amex,Processor Payout Batch,SET-20250326-Amex-Amex-GBP,,0,0,0,38578.28,38578.28,38578.28,261250760.86999965,261250760.86999965,ACH,GBP
2025-03-28,Settlement from Amex,Processor Payout Batch,SET-20250326-Amex-Amex-USD,,0,0,0,208614.84,208614.84,208614.84,261459375.70999965,261459375.70999965,ACH,USD
2025-03-28,Settlement from Amex,Processor Payout Batch,SET-20250326-Amex-Amex-AUD,,0,0,0,29637.15,29637.15,29637.15,261489012.85999966,261489012.85999966,ACH,AUD
2025-03-28,Settlement from ClientLine,Processor Payout Batch,SET-20250326-ClientLine-Mastercard-EUR,,0,0,0,40194.65,40194.65,40194.65,261529207.50999966,261529207.50999966,ACH,EUR
2025-03-28,Settlement from ClientLine,Processor Payout Batch,SET-20250326-ClientLine-Mastercard-GBP,,0,0,0,16153.86,16153.86,16153.86,261545361.36999968,261545361.36999968,ACH,GBP
2025-03-28,Settlement from ClientLine,Processor Payout Batch,SET-20250326-ClientLine-Mastercard-USD,,0,0,0,213035.29,213035.29,213035.29,261758396.65999967,261758396.65999967,ACH,USD
2025-03-28,Settlement from ClientLine,Processor Payout Batch,SET-20250326-ClientLine-Visa-AUD,,0,0,0,40606.3,40606.3,40606.3,261799002.95999968,261799002.95999968,ACH,AUD
2025-03-28,Settlement from ClientLine,Processor Payout Batch,SET-20250326-ClientLine-Mastercard-AUD,,0,0,0,51486.3,51486.3,51486.3,261850489.2599997,261850489.2599997,ACH,AUD
2025-03-31,Settlement from ClientLine,Processor Payout Batch,SET-20250327-ClientLine-Visa-USD,,0,0,0,176999.53,176999.53,176999.53,262027488.7899997,262027488.7899997,ACH,USD
2025-03-31,Settlement from GoCardless,Processor Payout Batch,SET-20250327-GoCardless-N/A-AUD,,0,0,0,44294.93,44294.93,44294.93,262071783.7199997,262071783.7199997,ACH,AUD
2025-03-31,Settlement from GoCardless,Processor Payout Batch,SET-20250327-GoCardless-N/A-CAD,,0,0,0,58595.48,58595.48,58595.48,262130379.1999997,262130379.1999997,ACH,CAD
2025-03-31,Settlement from GoCardless,Processor Payout Batch,SET-20250327-GoCardless-N/A-EUR,,0,0,0,180445.65,180445.65,180445.65,262310824.8499997,262310824.8499997,ACH,EUR
2025-03-31,Settlement from GoCardless,Processor Payout Batch,SET-20250327-GoCardless-N/A-GBP,,0,0,0,110596.43,110596.43,110596.43,262421421.2799997,262421421.2799997,ACH,GBP
2025-03-31,Settlement from PayPal,Processor Payout Batch,SET-20250327-PayPal-N/A-CAD,,0,0,0,69559.77,69559.77,69559.77,262490981.0499997,262490981.0499997,ACH,CAD
2025-03-31,Settlement from PayPal,Processor Payout Batch,SET-20250327-PayPal-N/A-AUD,,0,0,0,63345.35,63345.35,63345.35,262554326.3999997,262554326.3999997,ACH,AUD
2025-03-31,Settlement from PayPal,Processor Payout Batch,SET-20250327-PayPal-N/A-EUR,,0,0,0,167209.02,167209.02,167209.02,262721535.41999972,262721535.41999972,ACH,EUR
2025-03-31,Settlement from PayPal,Processor Payout Batch,SET-20250327-PayPal-N/A-GBP,,0,0,0,100565.7,100565.7,100565.7,262822101.1199997,262822101.1199997,ACH,GBP
2025-03-31,Settlement from PayPal,Processor Payout Batch,SET-20250327-PayPal-N/A-USD,,0,0,0,677078.57,677078.57,677078.57,263499179.6899997,263499179.6899997,ACH,USD
2025-03-31,Settlement from GoCardless,Processor Payout Batch,SET-20250327-GoCardless-N/A-USD,,0,0,0,587253.04,587253.04,587253.04,264086432.7299997,264086432.7299997,ACH,USD
2025-03-31,Settlement from ClientLine,Processor Payout Batch,SET-20250327-ClientLine-Visa-GBP,,0,0,0,47392.64,47392.64,47392.64,264133825.36999968,264133825.36999968,ACH,GBP
2025-03-31,Settlement from Amex,Processor Payout Batch,SET-20250327-Amex-Amex-AUD,,0,0,0,29242.27,29242.27,29242.27,264163067.6399997,264163067.6399997,ACH,AUD
2025-03-31,Settlement from ClientLine,Processor Payout Batch,SET-20250327-ClientLine-Visa-CAD,,0,0,0,15452.86,15452.86,15452.86,264178520.4999997,264178520.4999997,ACH,CAD
2025-03-31,Settlement from ClientLine,Processor Payout Batch,SET-20250327-ClientLine-Visa-AUD,,0,0,0,22526.9,22526.9,22526.9,264201047.3999997,264201047.3999997,ACH,AUD
2025-03-31,Settlement from ClientLine,Processor Payout Batch,SET-20250327-ClientLine-Mastercard-USD,,0,0,0,190948.95,190948.95,190948.95,264391996.3499997,264391996.3499997,ACH,USD
2025-03-31,Settlement from ClientLine,Processor Payout Batch,SET-20250327-ClientLine-Mastercard-GBP,,0,0,0,21593.78,21593.78,21593.78,264413590.1299997,264413590.1299997,ACH,GBP
2025-03-31,Settlement from ClientLine,Processor Payout Batch,SET-20250327-ClientLine-Mastercard-EUR,,0,0,0,35410.44,35410.44,35410.44,264449000.5699997,264449000.5699997,ACH,EUR
2025-03-31,Settlement from ClientLine,Processor Payout Batch,SET-20250327-ClientLine-Mastercard-CAD,,0,0,0,31681.31,31681.31,31681.31,264480681.8799997,264480681.8799997,ACH,CAD
2025-03-31,Settlement from ClientLine,Processor Payout Batch,SET-20250327-ClientLine-Mastercard-AUD,,0,0,0,28370.16,28370.16,28370.16,264509052.0399997,264509052.0399997,ACH,AUD
2025-03-31,Settlement from Amex,Processor Payout Batch,SET-20250327-Amex-Amex-USD,,0,0,0,149386.86,149386.86,149386.86,264658438.8999997,264658438.8999997,ACH,USD
2025-03-31,Settlement from Amex,Processor Payout Batch,SET-20250327-Amex-Amex-GBP,,0,0,0,34816.84,34816.84,34816.84,264693255.7399997,264693255.7399997,ACH,GBP
2025-03-31,Settlement from Amex,Processor Payout Batch,SET-20250327-Amex-Amex-EUR,,0,0,0,44692.96,44692.96,44692.96,264737948.69999972,264737948.69999972,ACH,EUR
2025-03-31,Settlement from Amex,Processor Payout Batch,SET-20250327-Amex-Amex-CAD,,0,0,0,28126.58,28126.58,28126.58,264766075.27999973,264766075.27999973,ACH,CAD
2025-03-31,Settlement from ClientLine,Processor Payout Batch,SET-20250327-ClientLine-Visa-EUR,,0,0,0,63240.94,63240.94,63240.94,264829316.21999973,264829316.21999973,ACH,EUR
2025-04-01,Settlement from ClientLine,Processor Payout Batch,SET-20250328-ClientLine-Visa-USD,,0,0,0,223493.87,223493.87,223493.87,265052810.08999974,265052810.08999974,ACH,USD
2025-04-01,Settlement from GoCardless,Processor Payout Batch,SET-20250328-GoCardless-N/A-AUD,,0,0,0,84927.67,84927.67,84927.67,265137737.75999972,265137737.75999972,ACH,AUD
2025-04-01,Settlement from GoCardless,Processor Payout Batch,SET-20250328-GoCardless-N/A-CAD,,0,0,0,59976.41,59976.41,59976.41,265197714.16999972,265197714.16999972,ACH,CAD
2025-04-01,Settlement from GoCardless,Processor Payout Batch,SET-20250328-GoCardless-N/A-EUR,,0,0,0,140970.0,140970.0,140970.0,265338684.16999972,265338684.16999972,ACH,EUR
2025-04-01,Settlement from PayPal,Processor Payout Batch,SET-20250328-PayPal-N/A-EUR,,0,0,0,161494.01,161494.01,161494.01,265500178.1799997,265500178.1799997,ACH,EUR
2025-04-01,Settlement from GoCardless,Processor Payout Batch,SET-20250328-GoCardless-N/A-USD,,0,0,0,607661.01,607661.01,607661.01,266107839.1899997,266107839.1899997,ACH,USD
2025-04-01,Settlement from PayPal,Processor Payout Batch,SET-20250328-PayPal-N/A-AUD,,0,0,0,105436.43,105436.43,105436.43,266213275.6199997,266213275.6199997,ACH,AUD
2025-04-01,Settlement from PayPal,Processor Payout Batch,SET-20250328-PayPal-N/A-CAD,,0,0,0,95173.86,95173.86,95173.86,266308449.47999972,266308449.47999972,ACH,CAD
2025-04-01,Settlement from ClientLine,Processor Payout Batch,SET-20250328-ClientLine-Visa-GBP,,0,0,0,42080.75,42080.75,42080.75,266350530.22999972,266350530.22999972,ACH,GBP
2025-04-01,Settlement from GoCardless,Processor Payout Batch,SET-20250328-GoCardless-N/A-GBP,,0,0,0,70837.07,70837.07,70837.07,266421367.2999997,266421367.2999997,ACH,GBP
2025-04-01,Settlement from ClientLine,Processor Payout Batch,SET-20250328-ClientLine-Visa-EUR,,0,0,0,47167.14,47167.14,47167.14,266468534.4399997,266468534.4399997,ACH,EUR
2025-04-01,Settlement from ClientLine,Processor Payout Batch,SET-20250328-ClientLine-Mastercard-CAD,,0,0,0,21164.3,21164.3,21164.3,266489698.7399997,266489698.7399997,ACH,CAD
2025-04-01,Settlement from ClientLine,Processor Payout Batch,SET-20250328-ClientLine-Visa-AUD,,0,0,0,29310.99,29310.99,29310.99,266519009.72999972,266519009.72999972,ACH,AUD
2025-04-01,Settlement from ClientLine,Processor Payout Batch,SET-20250328-ClientLine-Mastercard-USD,,0,0,0,211513.58,211513.58,211513.58,266730523.30999973,266730523.30999973,ACH,USD
2025-04-01,Settlement from ClientLine,Processor Payout Batch,SET-20250328-ClientLine-Mastercard-GBP,,0,0,0,33003.53,33003.53,33003.53,266763526.83999974,266763526.83999974,ACH,GBP
2025-04-01,Settlement from ClientLine,Processor Payout Batch,SET-20250328-ClientLine-Mastercard-EUR,,0,0,0,53299.84,53299.84,53299.84,266816826.67999974,266816826.67999974,ACH,EUR
2025-04-01,Settlement from ClientLine,Processor Payout Batch,SET-20250328-ClientLine-Mastercard-AUD,,0,0,0,16650.33,16650.33,16650.33,266833477.00999975,266833477.00999975,ACH,AUD
2025-04-01,Settlement from Amex,Processor Payout Batch,SET-20250328-Amex-Amex-USD,,0,0,0,172854.42,172854.42,172854.42,267006331.42999974,267006331.42999974,ACH,USD
2025-04-01,Settlement from Amex,Processor Payout Batch,SET-20250328-Amex-Amex-GBP,,0,0,0,17866.58,17866.58,17866.58,267024198.00999975,267024198.00999975,ACH,GBP
2025-04-01,Settlement from Amex,Processor Payout Batch,SET-20250328-Amex-Amex-EUR,,0,0,0,61100.5,61100.5,61100.5,267085298.50999975,267085298.50999975,ACH,EUR
2025-04-01,Settlement from Amex,Processor Payout Batch,SET-20250328-Amex-Amex-CAD,,0,0,0,30849.35,30849.35,30849.35,267116147.85999975,267116147.85999975,ACH,CAD
2025-04-01,Settlement from Amex,Processor Payout Batch,SET-20250328-Amex-Amex-AUD,,0,0,0,21402.55,21402.55,21402.55,267137550.40999976,267137550.40999976,ACH,AUD
2025-04-01,Settlement from PayPal,Processor Payout Batch,SET-20250328-PayPal-N/A-GBP,,0,0,0,68995.79,68995.79,68995.79,267206546.19999975,267206546.19999975,ACH,GBP
2025-04-01,Settlement from ClientLine,Processor Payout Batch,SET-20250328-ClientLine-Visa-CAD,,0,0,0,22371.31,22371.31,22371.31,267228917.50999975,267228917.50999975,ACH,CAD
2025-04-01,Settlement from PayPal,Processor Payout Batch,SET-20250328-PayPal-N/A-USD,,0,0,0,694412.44,694412.44,694412.44,267923329.94999975,267923329.94999975,ACH,USD
